,DESCRIZIONE COMUNE,PROVINCIA,POPOLAZIONE,POPOLAZIONE CENSITA UOMINI,POPOLAZIONE CENSITA DONNE,CODICE ELETTORALE,CODICE ISTAT,CODICE BELFIORE
0,ABANO TERME,PD,20123,9556,10567,1050540010,028001,A001
1,ABBADIA CERRETO,LO,275,139,136,1030990010,098001,A004
2,ABBADIA LARIANA,LC,3202,1565,1637,1030980010,097001,A005
3,ABBADIA SAN SALVATORE,SI,6023,2893,3130,2090750010,052001,A006
4,ABBASANTA,OR,2594,1267,1327,4200950010,095001,A007
5,ABBATEGGIO,PE,363,186,177,3130600010,068001,A008
6,ABBIATEGRASSO,MI,32383,15799,16584,1030490020,015002,A010
7,ABETONE CUTIGLIANO,PT,1902,941,961,2090630012,047023,M376
8,ABRIOLA,PZ,1317,639,678,3170640010,076001,A013
9,ACATE,RG,10581,5786,4795,4190650010,088001,A014
10,ACCADIA,FG,2182,1046,1136,3160310010,071001,A015
11,ACCEGLIO,CN,157,78,79,1010270010,004001,A016
12,ACCETTURA,MT,1648,813,835,3170470010,077001,A017
13,ACCIANO,AQ,282,152,130,3130380010,066001,A018
14,ACCUMOLI,RI,547,285,262,2120690010,057001,A019
15,ACERENZA,PZ,2130,1057,1073,3170640020,076002,A020
16,ACERNO,SA,2500,1270,1230,3150720010,065001,A023
17,ACERRA,,58494,28850,29644,3150510010,063001,A024
18,ACI BONACCORSI,CT,3525,1696,1829,4190210010,087001,A025
19,ACI CASTELLO,CT,17975,8605,9370,4190210020,087002,A026
20,ACI CATENA,CT,28124,13842,14282,4190210030,087003,A027
21,ACI SANT'ANTONIO,CT,18058,8986,9072,4190210050,087005,A029
22,ACIREALE,CT,50735,24653,26082,4190210040,087004,A028
23,ACQUAFONDATA,FR,276,147,129,2120330010,060001,A032
24,ACQUAFORMOSA,CS,1001,499,502,3180250010,078001,A033
25,ACQUAFREDDA,BS,1518,729,789,1030150010,017001,A034
26,ACQUALAGNA,PU,4182,2075,2107,2110590010,041001,A035
27,ACQUANEGRA CREMONESE,CR,1123,538,585,1030260010,019001,A039
28,ACQUANEGRA SUL CHIESE,MN,2736,1348,1388,1030450010,020001,A038
29,ACQUAPENDENTE,VT,5304,2594,2710,2120910010,056001,A040
30,ACQUAPPESA,CS,1743,862,881,3180250020,078002,A041
31,ACQUARO,VV,1891,912,979,3181030010,102001,A043
32,ACQUASANTA TERME,AP,2531,1272,1259,2110060010,044001,A044
33,ACQUASPARTA,TR,4436,2141,2295,2100800010,055001,A045
34,ACQUAVIVA COLLECROCE,CB,585,295,290,3140190010,070001,A050
35,ACQUAVIVA D'ISERNIA,IS,377,194,183,3140940010,094001,A051
36,ACQUAVIVA DELLE FONTI,BA,20087,9739,10348,3160090010,072001,A048
37,ACQUAVIVA PICENA,AP,3692,1802,1890,2110060020,044002,A047
38,ACQUAVIVA PLATANI,CL,891,440,451,4190180010,085001,A049
39,ACQUEDOLCI,ME,5494,2669,2825,4190480001,083107,M211
40,ACQUI TERME,AL,19043,8916,10127,1010020010,006001,A052
41,ACRI,CS,19127,9253,9874,3180250030,078003,A053
42,ACUTO,FR,1875,926,949,2120330020,060002,A054
43,ADELFIA,BA,16554,8116,8438,3160090020,072002,A055
44,ADRANO,CT,34110,16483,17627,4190210060,087006,A056
45,ADRARA SAN MARTINO,BG,2172,1145,1027,1030120010,016001,A057
46,ADRARA SAN ROCCO,BG,807,426,381,1030120020,016002,A058
47,ADRIA,RO,18781,9125,9656,1050710010,029001,A059
48,ADRO,BS,7171,3575,3596,1030150020,017002,A060
49,AFFI,VR,2387,1178,1209,1050890010,023001,A061
50,AFFILE,RM,1433,725,708,2120700010,058001,A062
51,AFRAGOLA,,62198,30718,31480,3150510020,063002,A064
52,AFRICO,RC,2783,1397,1386,3180670010,080001,A065
53,AGAZZANO,PC,1975,964,1011,1080610010,033001,A067
54,AGEROLA,,7666,3789,3877,3150510030,063003,A068
55,AGGIUS,SS,1405,675,730,4200730010,090001,A069
56,AGIRA,EN,7726,3807,3919,4190280010,086001,A070
57,AGLIANA,PT,17950,8857,9093,2090630020,047002,A071
58,AGLIANO TERME,AT,1526,771,755,1010070010,005001,A072
59,AGLIE',TO,2562,1215,1347,1010810010,001001,A074
60,AGLIENTU,SS,1168,584,584,4200730011,090062,H848
61,AGNA,PD,3152,1557,1595,1050540020,028002,A075
62,AGNADELLO,CR,3842,1948,1894,1030260020,019002,A076
63,AGNANA CALABRA,RC,466,240,226,3180670020,080002,A077
64,AGNONE,IS,4703,2342,2361,3140940020,094002,A080
65,AGNOSINE,BS,1622,832,790,1030150030,017003,A082
66,AGORDO,BL,4085,1933,2152,1050100010,025001,A083
67,AGOSTA,RM,1704,837,867,2120700020,058002,A084
68,AGRA,VA,407,204,203,1030860010,012001,A085
69,AGRATE BRIANZA,MB,15505,7631,7874,1031040010,108001,A087
70,AGRATE CONTURBIA,NO,1520,783,737,1010520010,003001,A088
71,AGRIGENTO,AG,55849,27337,28512,4190010010,084001,A089
72,AGROPOLI,SA,21173,10448,10725,3150720020,065002,A091
73,AGUGLIANO,AN,4682,2308,2374,2110030010,042001,A092
74,AGUGLIARO,VI,1414,712,702,1050900010,024001,A093
75,AICURZIO,MB,2071,1028,1043,1031040020,108002,A096
76,AIDOMAGGIORE,OR,398,180,218,4200950020,095002,A097
77,AIDONE,EN,4284,2127,2157,4190280020,086002,A098
78,AIELLI,AQ,1423,717,706,3130380020,066002,A100
79,AIELLO CALABRO,CS,1435,709,726,3180250040,078004,A102
80,AIELLO DEL FRIULI,UD,2174,1042,1132,1060850010,030001,A103
81,AIELLO DEL SABATO,AV,4007,1997,2010,3150080010,064001,A101
82,AIETA,CS,765,373,392,3180250050,078005,A105
83,AILANO,CE,1225,558,667,3150200010,061001,A106
84,AILOCHE,BI,314,147,167,1010960010,096001,A107
85,AIRASCA,TO,3660,1867,1793,1010810020,001002,A109
86,AIROLA,BN,8134,4032,4102,3150110010,062001,A110
87,AIROLE,IM,363,191,172,1070370010,008001,A111
88,AIRUNO,LC,2832,1463,1369,1030980020,097002,A112
89,AISONE,CN,205,103,102,1010270020,004002,A113
90,ALA,TN,8801,4427,4374,1040830010,022001,A116
91,ALA DI STURA,TO,467,242,225,1010810030,001003,A117
92,ALA' DEI SARDI,SS,1789,895,894,4200730020,090002,A115
93,ALAGNA,PV,799,394,405,1030570010,018001,A118
94,ALAGNA VALSESIA,VC,730,378,352,1010880020,002002,A119
95,ALANNO,PE,3390,1628,1762,3130600020,068002,A120
96,ALASSIO,SV,10168,4705,5463,1070740010,009001,A122
97,ALATRI,FR,27860,13642,14218,2120330030,060003,A123
98,ALBA,CN,31095,14746,16349,1010270030,004003,A124
99,ALBA ADRIATICA,TE,12741,6117,6624,3130790001,067001,A125
100,ALBAGIARA,OR,246,122,124,4200950030,095003,A126
101,ALBAIRATE,MI,4713,2324,2389,1030490050,015005,A127
102,ALBANELLA,SA,6273,3126,3147,3150720030,065003,A128
103,ALBANO DI LUCANIA,PZ,1362,697,665,3170640030,076003,A131
104,ALBANO LAZIALE,RM,39674,19093,20581,2120700030,058003,A132
105,ALBANO SANT'ALESSANDRO,BG,8274,4164,4110,1030120030,016003,A129
106,ALBANO VERCELLESE,VC,310,153,157,1010880030,002003,A130
107,ALBAREDO D'ADIGE,VR,5272,2659,2613,1050890020,023002,A137
108,ALBAREDO PER SAN MARCO,SO,291,155,136,1030770010,014001,A135
109,ALBARETO,PR,2072,1016,1056,1080560010,034001,A138
110,ALBARETTO DELLA TORRE,CN,221,113,108,1010270040,004004,A139
111,ALBAVILLA,CO,6360,3124,3236,1030240030,013003,A143
112,ALBENGA,SV,23435,11441,11994,1070740020,009002,A145
113,ALBERA LIGURE,AL,314,170,144,1010020020,006002,A146
114,ALBEROBELLO,BA,10331,5003,5328,3160090030,072003,A149
115,ALBERONA,FG,849,410,439,3160310020,071002,A150
116,ALBESE CON CASSANO,CO,4189,2062,2127,1030240040,013004,A153
117,ALBETTONE,VI,1982,1004,978,1050900020,024002,A154
118,ALBI,CZ,830,424,406,3180220020,079002,A155
119,ALBIANO,TN,1494,772,722,1040830020,022002,A158
120,ALBIANO D'IVREA,TO,1637,785,852,1010810040,001004,A157
121,ALBIATE,MB,6574,3210,3364,1031040030,108003,A159
122,ALBIDONA,CS,1184,583,601,3180250060,078006,A160
123,ALBIGNASEGO,PD,26642,12921,13721,1050540030,028003,A161
124,ALBINEA,RE,8788,4291,4497,1080680010,035001,A162
125,ALBINO,BG,17492,8625,8867,1030120040,016004,A163
126,ALBIOLO,CO,2725,1360,1365,1030240050,013005,A164
127,ALBISOLA SUPERIORE,SV,9644,4503,5141,1070740040,009004,A166
128,ALBISSOLA MARINA,SV,5259,2502,2757,1070740030,009003,A165
129,ALBIZZATE,VA,5195,2544,2651,1030860020,012002,A167
130,ALBONESE,PV,533,259,274,1030570030,018003,A171
131,ALBOSAGGIA,SO,3011,1510,1501,1030770020,014002,A172
132,ALBUGNANO,AT,498,244,254,1010070020,005002,A173
133,ALBUZZANO,PV,3574,1781,1793,1030570040,018004,A175
134,ALCAMO,TP,44719,22053,22666,4190820010,081001,A176
135,ALCARA LI FUSI,ME,1742,829,913,4190480010,083001,A177
136,ALDENO,TN,3188,1564,1624,1040830030,022003,A178
137,ALDINO/ALDEIN,BZ,1631,838,793,1040140002,021001,A179
138,ALES,OR,1293,658,635,4200950040,095004,A180
139,ALESSANDRIA,AL,90825,44072,46753,1010020030,006003,A182
140,ALESSANDRIA DEL CARRETTO,CS,362,198,164,3180250070,078007,A183
141,ALESSANDRIA DELLA ROCCA,AG,2521,1226,1295,4190010020,084002,A181
142,ALESSANO,LE,6080,2919,3161,3160410020,075002,A184
143,ALEZIO,LE,5629,2681,2948,3160410030,075003,A185
144,ALFANO,SA,964,460,504,3150720040,065004,A186
145,ALFEDENA,AQ,925,528,397,3130380030,066003,A187
146,ALFIANELLO,BS,2372,1196,1176,1030150040,017004,A188
147,ALFIANO NATTA,AL,727,365,362,1010020040,006004,A189
148,ALFONSINE,RA,11506,5619,5887,1080660010,039001,A191
149,ALGHERO,SS,42458,20419,22039,4200730030,090003,A192
150,ALGUA,BG,656,332,324,1030120041,016248,A193
151,ALI',ME,685,336,349,4190480020,083002,A194
152,ALI' TERME,ME,2369,1152,1217,4190480030,083003,A201
153,ALIA,PA,3367,1614,1753,4190550010,082001,A195
154,ALIANO,MT,893,446,447,3170470020,077002,A196
155,ALICE BEL COLLE,AL,713,384,329,1010020050,006005,A197
156,ALICE CASTELLO,VC,2503,1260,1243,1010880040,002004,A198
157,ALIFE,CE,7390,3675,3715,3150200020,061002,A200
158,ALIMENA,PA,1773,842,931,4190550020,082002,A202
159,ALIMINUSA,PA,1089,562,527,4190550030,082003,A203
160,ALLAI,OR,358,182,176,4200950050,095005,A204
161,ALLEGHE,BL,1110,538,572,1050100030,025003,A206
162,ALLEIN,AO,211,103,108,1020040010,007001,A205
163,ALLERONA,TR,1685,822,863,2100800020,055002,A207
164,ALLISTE,LE,6481,3106,3375,3160410040,075004,A208
165,ALLUMIERE,RM,3778,1875,1903,2120700040,058004,A210
166,ALLUVIONI PIOVERA,AL,1616,795,821,1010020062,006192,M397
167,ALME',BG,5507,2669,2838,1030120050,016005,A214
168,ALMENNO SAN BARTOLOMEO,BG,6504,3253,3251,1030120070,016006,A216
169,ALMENNO SAN SALVATORE,BG,5536,2713,2823,1030120080,016007,A217
170,ALMESE,TO,6331,3099,3232,1010810060,001006,A218
171,ALONTE,VI,1593,811,782,1050900030,024003,A220
172,ALPAGO,BL,6617,3313,3304,1050100035,025072,M375
173,ALPETTE,TO,240,127,113,1010810070,001007,A221
174,ALPIGNANO,TO,16501,8155,8346,1010810080,001008,A222
175,ALSENO,PC,4672,2293,2379,1080610020,033002,A223
176,ALSERIO,CO,1303,653,650,1030240060,013006,A224
177,ALTA VAL TIDONE,PC,2906,1474,1432,1080610025,033049,M386
178,ALTA VALLE INTELVI,CO,3022,1527,1495,1030240065,013253,M383
179,ALTAMURA,BA,69855,34323,35532,3160090040,072004,A225
180,ALTARE,SV,1932,967,965,1070740050,009005,A226
181,ALTAVALLE,TN,1629,813,816,1040830034,022235,M349
182,ALTAVILLA IRPINA,AV,4004,1979,2025,3150080020,064002,A228
183,ALTAVILLA MILICIA,PA,8500,4260,4240,4190550040,082004,A229
184,ALTAVILLA MONFERRATO,AL,399,216,183,1010020070,006007,A227
185,ALTAVILLA SILENTINA,SA,6962,3444,3518,3150720050,065005,A230
186,ALTAVILLA VICENTINA,VI,11820,5869,5951,1050900040,024004,A231
187,ALTIDONA,FM,3507,1715,1792,2111050010,109001,A233
188,ALTILIA,CS,673,366,307,3180250080,078008,A234
189,ALTINO,CH,3075,1506,1569,3130230010,069001,A235
190,ALTISSIMO,VI,2152,1121,1031,1050900050,024005,A236
191,ALTIVOLE,TV,7015,3475,3540,1050840010,026001,A237
192,ALTO,CN,142,76,66,1010270050,004005,A238
193,ALTO RENO TERME,BO,6887,3354,3533,1080130005,037062,M369
194,ALTO SERMENZA,VC,145,82,63,1010880045,002170,M389
195,ALTOFONTE,PA,9903,4807,5096,4190550050,082005,A239
196,ALTOMONTE,CS,4074,2008,2066,3180250090,078009,A240
197,ALTOPASCIO,LU,15726,7787,7939,2090430010,046001,A241
198,ALTOPIANO DELLA VIGOLANA,TN,5140,2570,2570,1040830037,022236,M350
199,ALVIANO,TR,1396,670,726,2100800030,055003,A242
200,ALVIGNANO,CE,4564,2231,2333,3150200030,061003,A243
201,ALVITO,FR,2511,1249,1262,2120330040,060004,A244
202,ALZANO LOMBARDO,BG,13424,6579,6845,1030120090,016008,A246
203,ALZANO SCRIVIA,AL,348,184,164,1010020080,006008,A245
204,ALZATE BRIANZA,CO,4842,2398,2444,1030240070,013007,A249
205,AMALFI,SA,4830,2347,2483,3150720060,065006,A251
206,AMANDOLA,FM,3303,1646,1657,2111050020,109002,A252
207,AMANTEA,CS,13889,6800,7089,3180250100,078010,A253
208,AMARO,UD,844,418,426,1060850020,030002,A254
209,AMARONI,CZ,1680,814,866,3180220030,079003,A255
210,AMASENO,FR,4095,2061,2034,2120330050,060005,A256
211,AMATO,CZ,787,384,403,3180220040,079004,A257
212,AMATRICE,RI,2293,1217,1076,2120690020,057002,A258
213,AMBIVERE,BG,2366,1218,1148,1030120100,016009,A259
214,AMBLAR-DON,TN,547,274,273,1040830042,022237,M351
215,AMEGLIA,SP,4318,2122,2196,1070390010,011001,A261
216,AMELIA,TR,11607,5695,5912,2100800040,055004,A262
217,AMENDOLARA,CS,2760,1368,1392,3180250110,078011,A263
218,AMENO,NO,850,431,419,1010520020,003002,A264
219,AMOROSI,BN,2641,1312,1329,3150110020,062002,A265
220,AMPEZZO,UD,920,459,461,1060850030,030003,A267
221,ANACAPRI,,6882,3386,3496,3150510040,063004,A268
222,ANAGNI,FR,20792,10199,10593,2120330060,060006,A269
223,ANCARANO,TE,1811,909,902,3130790010,067002,A270
224,ANCONA,AN,98402,47673,50729,2110030020,042002,A271
225,ANDALI,CZ,662,324,338,3180220050,079005,A272
226,ANDALO,TN,1145,562,583,1040830050,022005,A274
227,ANDALO VALTELLINO,SO,597,306,291,1030770030,014003,A273
228,ANDEZENO,TO,2036,1018,1018,1010810090,001009,A275
229,ANDORA,SV,7261,3485,3776,1070740060,009006,A278
230,ANDORNO MICCA,BI,3043,1461,1582,1010960020,096002,A280
231,ANDRANO,LE,4609,2215,2394,3160410050,075005,A281
232,ANDRATE,TO,474,260,214,1010810100,001010,A282
233,ANDREIS,PN,246,125,121,1060930010,093001,A283
234,ANDRETTA,AV,1688,817,871,3150080030,064003,A284
235,ANDRIA,BT,97588,48180,49408,3161060010,110001,A285
236,ANDRIANO/ANDRIAN,BZ,1012,517,495,1040140001,021002,A286
237,ANELA,SS,588,293,295,4200730040,090004,A287
238,ANFO,BS,450,237,213,1030150050,017005,A288
239,ANGERA,VA,5396,2568,2828,1030860030,012003,A290
240,ANGHIARI,AR,5385,2628,2757,2090050010,051001,A291
241,ANGIARI,VR,2448,1218,1230,1050890030,023003,A292
242,ANGOLO TERME,BS,2309,1167,1142,1030150060,017006,A293
243,ANGRI,SA,33963,16613,17350,3150720070,065007,A294
244,ANGROGNA,TO,827,433,394,1010810110,001011,A295
245,ANGUILLARA SABAZIA,RM,19167,9396,9771,2120700050,058005,A297
246,ANGUILLARA VENETA,PD,4156,2037,2119,1050540040,028004,A296
247,ANNICCO,CR,1983,1006,977,1030260030,019003,A299
248,ANNONE DI BRIANZA,LC,2285,1133,1152,1030980030,097003,A301
249,ANNONE VENETO,VE,3814,1925,1889,1050870010,027001,A302
250,ANOIA,RC,2048,966,1082,3180670030,080003,A303
251,ANTEGNATE,BG,3227,1634,1593,1030120110,016010,A304
252,ANTERIVO/ALTREI,BZ,399,201,198,1040140010,021003,A306
253,ANTEY-SAINT-ANDRE',AO,542,266,276,1020040020,007002,A305
254,ANTICOLI CORRADO,RM,837,416,421,2120700060,058006,A309
255,ANTIGNANO,AT,949,475,474,1010070030,005003,A312
256,ANTILLO,ME,840,426,414,4190480040,083004,A313
257,ANTONIMINA,RC,1191,600,591,3180670040,080004,A314
258,ANTRODOCO,RI,2356,1197,1159,2120690030,057003,A315
259,ANTRONA SCHIERANCO,VB,400,198,202,1011020010,103001,A317
260,ANVERSA DEGLI ABRUZZI,AQ,303,154,149,3130380040,066004,A318
261,ANZANO DEL PARCO,CO,1755,872,883,1030240090,013009,A319
262,ANZANO DI PUGLIA,FG,1103,532,571,3160310030,071003,A320
263,ANZI,PZ,1553,751,802,3170640040,076004,A321
264,ANZIO,RM,58593,29499,29094,2120700070,058007,A323
265,ANZOLA D'OSSOLA,VB,381,194,187,1011020020,103002,A325
266,ANZOLA DELL'EMILIA,BO,12313,6077,6236,1080130010,037001,A324
267,AOSTA,AO,33223,15615,17608,1020040030,007003,A326
268,APECCHIO,PU,1735,857,878,2110590020,041002,A327
269,APICE,BN,5349,2652,2697,3150110030,062003,A328
270,APIRO,MC,2050,999,1051,2110440020,043002,A329
271,APOLLOSA,BN,2485,1246,1239,3150110040,062004,A330
272,APPIANO GENTILE,CO,7685,3743,3942,1030240100,013010,A333
273,APPIANO SULLA STRADA DEL VINO/EPPAN AN DER WEINSTRASSE,BZ,14741,7281,7460,1040140020,021004,A332
274,APPIGNANO,MC,4030,1944,2086,2110440030,043003,A334
275,APPIGNANO DEL TRONTO,AP,1693,823,870,2110060050,044005,A335
276,APRICA,SO,1495,738,757,1030770040,014004,A337
277,APRICALE,IM,628,325,303,1070370020,008002,A338
278,APRICENA,FG,12617,6247,6370,3160310040,071004,A339
279,APRIGLIANO,CS,2384,1171,1213,3180250120,078012,A340
280,APRILIA,LT,74119,36782,37337,2120400010,059001,A341
281,AQUARA,SA,1362,673,689,3150720080,065008,A343
282,AQUILA D'ARROSCIA,IM,147,78,69,1070370030,008003,A344
283,AQUILEIA,UD,3148,1541,1607,1060850040,030004,A346
284,AQUILONIA,AV,1507,782,725,3150080040,064004,A347
285,AQUINO,FR,4999,2460,2539,2120330070,060007,A348
286,ARADEO,LE,8928,4267,4661,3160410060,075006,A350
287,ARAGONA,AG,8860,4299,4561,4190010030,084003,A351
288,ARAMENGO,AT,565,289,276,1010070040,005004,A352
289,ARBA,PN,1274,648,626,1060930020,093002,A354
290,ARBOREA,OR,3777,1885,1892,4200950060,095006,A357
291,ARBORIO,VC,830,442,388,1010880060,002006,A358
292,ARBUS,SU,5843,2872,2971,4201110010,111001,A359
293,ARCADE,TV,4504,2273,2231,1050840020,026002,A360
294,ARCE,FR,5430,2667,2763,2120330080,060008,A363
295,ARCENE,BG,4815,2427,2388,1030120120,016011,A365
296,ARCEVIA,AN,4286,2134,2152,2110030030,042003,A366
297,ARCHI,CH,2032,998,1034,3130230020,069002,A367
298,ARCIDOSSO,GR,4226,2103,2123,2090360010,053001,A369
299,ARCINAZZO ROMANO,RM,1236,615,621,2120700080,058008,A370
300,ARCISATE,VA,9915,4849,5066,1030860040,012004,A371
301,ARCO,TN,17691,8634,9057,1040830060,022006,A372
302,ARCOLA,SP,10183,4955,5228,1070390020,011002,A373
303,ARCOLE,VR,6329,3157,3172,1050890040,023004,A374
304,ARCONATE,MI,6758,3325,3433,1030490070,015007,A375
305,ARCORE,MB,17828,8653,9175,1031040040,108004,A376
306,ARCUGNANO,VI,7717,3886,3831,1050900060,024006,A377
307,ARDARA,SS,736,376,360,4200730050,090005,A379
308,ARDAULI,OR,780,367,413,4200950070,095007,A380
309,ARDEA,RM,48864,24821,24043,2120700081,058117,M213
310,ARDENNO,SO,3222,1630,1592,1030770050,014005,A382
311,ARDESIO,BG,3344,1695,1649,1030120130,016012,A383
312,ARDORE,RC,4780,2338,2442,3180670050,080005,A385
313,ARENA,VV,1253,607,646,3181030020,102002,A386
314,ARENA PO,PV,1522,770,752,1030570050,018005,A387
315,ARENZANO,GE,11163,5291,5872,1070340010,010001,A388
316,ARESE,MI,19551,9413,10138,1030490090,015009,A389
317,AREZZO,AR,96717,46733,49984,2090050020,051002,A390
318,ARGEGNO,CO,679,331,348,1030240110,013011,A391
319,ARGELATO,BO,9693,4760,4933,1080130020,037002,A392
320,ARGENTA,FE,20995,10266,10729,1080290010,038001,A393
321,ARGENTERA,CN,78,38,40,1010270060,004006,A394
322,ARGUELLO,CN,199,104,95,1010270070,004007,A396
323,ARGUSTO,CZ,458,220,238,3180220070,079007,A397
324,ARI,CH,1068,546,522,3130230030,069003,A398
325,ARIANO IRPINO,AV,21240,10378,10862,3150080050,064005,A399
326,ARIANO NEL POLESINE,RO,4000,1934,2066,1050710020,029002,A400
327,ARICCIA,RM,18117,8735,9382,2120700090,058009,A401
328,ARIELLI,CH,1081,518,563,3130230040,069004,A402
329,ARIENZO,CE,5290,2598,2692,3150200040,061004,A403
330,ARIGNANO,TO,1072,569,503,1010810120,001012,A405
331,ARITZO,NU,1237,645,592,4200530010,091001,A407
332,ARIZZANO,VB,1941,931,1010,1011020030,103003,A409
333,ARLENA DI CASTRO,VT,827,425,402,2120910020,056002,A412
334,ARLUNO,MI,12275,6091,6184,1030490100,015010,A413
335,ARMENO,NO,2110,1003,1107,1010520060,003006,A414
336,ARMENTO,PZ,579,280,299,3170640050,076005,A415
337,ARMO,IM,118,61,57,1070370040,008004,A418
338,ARMUNGIA,SU,428,219,209,4201110020,111002,A419
339,ARNAD,AO,1249,591,658,1020040040,007004,A424
340,ARNARA,FR,2199,1058,1141,2120330090,060009,A421
341,ARNASCO,SV,573,292,281,1070740070,009007,A422
342,ARNESANO,LE,3946,1967,1979,3160410070,075007,A425
343,AROLA,VB,241,123,118,1011020040,103004,A427
344,ARONA,NO,13675,6414,7261,1010520070,003008,A429
345,AROSIO,CO,5114,2497,2617,1030240120,013012,A430
346,ARPAIA,BN,1981,988,993,3150110050,062005,A431
347,ARPAISE,BN,727,361,366,3150110060,062006,A432
348,ARPINO,FR,6799,3310,3489,2120330100,060010,A433
349,ARQUA' PETRARCA,PD,1817,903,914,1050540050,028005,A434
350,ARQUA' POLESINE,RO,2616,1296,1320,1050710030,029003,A435
351,ARQUATA DEL TRONTO,AP,1013,513,500,2110060060,044006,A437
352,ARQUATA SCRIVIA,AL,6236,3027,3209,1010020090,006009,A436
353,ARRE,PD,2097,1059,1038,1050540060,028006,A438
354,ARRONE,TR,2561,1240,1321,2100800050,055005,A439
355,ARSAGO SEPRIO,VA,4785,2376,2409,1030860050,012005,A441
356,ARSIE',BL,2203,1086,1117,1050100040,025004,A443
357,ARSIERO,VI,3021,1536,1485,1050900070,024007,A444
358,ARSITA,TE,756,375,381,3130790020,067003,A445
359,ARSOLI,RM,1387,642,745,2120700100,058010,A446
360,ARTA TERME,UD,2056,1029,1027,1060850050,030005,A447
361,ARTEGNA,UD,2882,1396,1486,1060850060,030006,A448
362,ARTENA,RM,13666,6753,6913,2120700110,058011,A449
363,ARTOGNE,BS,3567,1789,1778,1030150061,017007,A451
364,ARVIER,AO,833,415,418,1020040050,007005,A452
365,ARZACHENA,SS,13328,6746,6582,4200730060,090006,A453
366,ARZAGO D'ADDA,BG,2744,1370,1374,1030120140,016013,A440
367,ARZANA,NU,2259,1141,1118,4200530020,091002,A454
368,ARZANO,,32465,15891,16574,3150510050,063005,A455
369,ARZERGRANDE,PD,4800,2378,2422,1050540070,028007,A458
370,ARZIGNANO,VI,25094,12741,12353,1050900080,024008,A459
371,ASCEA,SA,5808,2888,2920,3150720090,065009,A460
372,ASCIANO,SI,6812,3309,3503,2090750020,052002,A461
373,ASCOLI PICENO,AP,46085,22238,23847,2110060070,044007,A462
374,ASCOLI SATRIANO,FG,5925,3023,2902,3160310050,071005,A463
375,ASCREA,RI,215,117,98,2120690040,057004,A464
376,ASIAGO,VI,6361,3067,3294,1050900090,024009,A465
377,ASIGLIANO VENETO,VI,844,428,416,1050900100,024010,A467
378,ASIGLIANO VERCELLESE,VC,1382,696,686,1010880070,002007,A466
379,ASOLA,MN,9912,4867,5045,1030450020,020002,A470
380,ASOLO,TV,8960,4518,4442,1050840030,026003,A471
381,ASSAGO,MI,9140,4511,4629,1030490110,015011,A473
382,ASSEMINI,CA,26159,12804,13355,4200170030,092003,A474
383,ASSISI,PG,27880,13481,14399,2100580010,054001,A475
384,ASSO,CO,3528,1740,1788,1030240130,013013,A476
385,ASSOLO,OR,348,179,169,4200950080,095008,A477
386,ASSORO,EN,4868,2390,2478,4190280030,086003,A478
387,ASTI,AT,73723,35488,38235,1010070050,005005,A479
388,ASUNI,OR,311,152,159,4200950090,095009,A480
389,ATELETA,AQ,1093,553,540,3130380050,066005,A481
390,ATELLA,PZ,3681,1842,1839,3170640060,076006,A482
391,ATENA LUCANA,SA,2396,1196,1200,3150720100,065010,A484
392,ATESSA,CH,10441,5099,5342,3130230050,069005,A485
393,ATINA,FR,4129,1989,2140,2120330110,060011,A486
394,ATRANI,SA,802,391,411,3150720110,065011,A487
395,ATRI,TE,10064,4982,5082,3130790030,067004,A488
396,ATRIPALDA,AV,10455,5046,5409,3150080060,064006,A489
397,ATTIGLIANO,TR,1969,964,1005,2100800060,055006,A490
398,ATTIMIS,UD,1683,808,875,1060850070,030007,A491
399,ATZARA,NU,1026,531,495,4200530030,091003,A492
400,AUGUSTA,SR,34715,17171,17544,4190760010,089001,A494
401,AULETTA,SA,2150,1078,1072,3150720120,065012,A495
402,AULLA,MS,10719,5217,5502,2090460010,045001,A496
403,AURANO,VB,103,55,48,1011020050,103005,A497
404,AURIGO,IM,337,169,168,1070370041,008005,A499
405,AURONZO DI CADORE,BL,3110,1505,1605,1050100050,025005,A501
406,AUSONIA,FR,2431,1210,1221,2120330120,060012,A502
407,AUSTIS,NU,772,387,385,4200530040,091004,A503
408,AVEGNO,GE,2519,1265,1254,1070340020,010002,A506
409,AVELENGO/HAFLING,BZ,811,408,403,1040140021,021005,A507
410,AVELLA,AV,7606,3705,3901,3150080070,064007,A508
411,AVELLINO,AV,52498,24788,27710,3150080080,064008,A509
412,AVERARA,BG,173,93,80,1030120150,016014,A511
413,AVERSA,CE,50194,24136,26058,3150200050,061005,A512
414,AVETRANA,TA,6311,3031,3280,3160780010,073001,A514
415,AVEZZANO,AQ,41026,19816,21210,3130380060,066006,A515
416,AVIANO,PN,8866,4415,4451,1060930040,093004,A516
417,AVIATICO,BG,575,320,255,1030120160,016015,A517
418,AVIGLIANA,TO,12350,6034,6316,1010810130,001013,A518
419,AVIGLIANO,PZ,10716,5223,5493,3170640070,076007,A519
420,AVIGLIANO UMBRO,TR,2384,1214,1170,2100800061,055033,M258
421,AVIO,TN,4108,2044,2064,1040830070,022007,A520
422,AVISE,AO,299,144,155,1020040060,007006,A521
423,AVOLA,SR,30474,15008,15466,4190760020,089002,A522
424,AVOLASCA,AL,253,127,126,1010020100,006010,A523
425,AYAS,AO,1359,683,676,1020040070,007007,A094
426,AYMAVILLES,AO,2114,1036,1078,1020040080,007008,A108
427,AZEGLIO,TO,1240,611,629,1010810140,001014,A525
428,AZZANELLO,CR,615,297,318,1030260040,019004,A526
429,AZZANO D'ASTI,AT,384,181,203,1010070060,005006,A527
430,AZZANO DECIMO,PN,15660,7784,7876,1060930050,093005,A530
431,AZZANO MELLA,BS,3398,1727,1671,1030150062,017008,A529
432,AZZANO SAN PAOLO,BG,7596,3693,3903,1030120170,016016,A528
433,AZZATE,VA,4621,2231,2390,1030860060,012006,A531
434,AZZIO,VA,755,392,363,1030860061,012007,A532
435,AZZONE,BG,372,188,184,1030120180,016017,A533
436,BACENO,VB,869,416,453,1011020060,103006,A534
437,BACOLI,,25410,12442,12968,3150510060,063006,A535
438,BADALUCCO,IM,1068,521,547,1070370050,008006,A536
439,BADESI,SS,1838,908,930,4200730061,090081,M214
440,BADIA CALAVENA,VR,2581,1322,1259,1050890050,023005,A540
441,BADIA PAVESE,PV,394,206,188,1030570060,018006,A538
442,BADIA POLESINE,RO,10020,4885,5135,1050710040,029004,A539
443,BADIA TEDALDA,AR,971,503,468,2090050030,051003,A541
444,BADIA/ABTEI,BZ,3533,1751,1782,1040140030,021006,A537
445,BADOLATO,CZ,2831,1347,1484,3180220080,079008,A542
446,BAGALADI,RC,953,438,515,3180670060,080006,A544
447,BAGHERIA,PA,53221,25972,27249,4190550060,082006,A546
448,BAGNACAVALLO,RA,16398,7997,8401,1080660020,039002,A547
449,BAGNARA CALABRA,RC,9373,4665,4708,3180670070,080007,A552
450,BAGNARA DI ROMAGNA,RA,2405,1199,1206,1080660030,039003,A551
451,BAGNARIA,PV,632,299,333,1030570070,018007,A550
452,BAGNARIA ARSA,UD,3453,1710,1743,1060850080,030008,A553
453,BAGNASCO,CN,973,463,510,1010270080,004008,A555
454,BAGNATICA,BG,4439,2234,2205,1030120181,016018,A557
455,BAGNI DI LUCCA,LU,5593,2788,2805,2090430020,046002,A560
456,BAGNO A RIPOLI,FI,25314,12039,13275,2090300010,048001,A564
457,BAGNO DI ROMAGNA,FC,5618,2743,2875,1080320010,040001,A565
458,BAGNOLI DEL TRIGNO,IS,649,332,317,3140940030,094003,A567
459,BAGNOLI DI SOPRA,PD,3386,1701,1685,1050540080,028008,A568
460,BAGNOLI IRPINO,AV,3029,1511,1518,3150080090,064009,A566
461,BAGNOLO CREMASCO,CR,4931,2461,2470,1030260050,019005,A570
462,BAGNOLO DEL SALENTO,LE,1767,865,902,3160410080,075008,A572
463,BAGNOLO DI PO,RO,1235,633,602,1050710050,029005,A574
464,BAGNOLO IN PIANO,RE,9540,4657,4883,1080680020,035002,A573
465,BAGNOLO MELLA,BS,12494,6231,6263,1030150070,017009,A569
466,BAGNOLO PIEMONTE,CN,5817,2894,2923,1010270090,004009,A571
467,BAGNOLO SAN VITO,MN,5850,2905,2945,1030450030,020003,A575
468,BAGNONE,MS,1722,855,867,2090460020,045002,A576
469,BAGNOREGIO,VT,3482,1659,1823,2120910030,056003,A577
470,BAGOLINO,BS,3755,1879,1876,1030150080,017010,A578
471,BAIA E LATINA,CE,2036,1004,1032,3150200060,061006,A579
472,BAIANO,AV,4515,2183,2332,3150080100,064010,A580
473,BAIRO,TO,790,371,419,1010810150,001015,A584
474,BAISO,RE,3218,1650,1568,1080680030,035003,A586
475,BAJARDO,IM,372,225,147,1070370060,008007,A581
476,BALANGERO,TO,3064,1486,1578,1010810160,001016,A587
477,BALDICHIERI D'ASTI,AT,1090,541,549,1010070070,005007,A588
478,BALDISSERO CANAVESE,TO,530,259,271,1010810170,001017,A590
479,BALDISSERO D'ALBA,CN,1048,535,513,1010270100,004010,A589
480,BALDISSERO TORINESE,TO,3755,1873,1882,1010810180,001018,A591
481,BALESTRATE,PA,6239,2989,3250,4190550070,082007,A592
482,BALESTRINO,SV,525,261,264,1070740080,009008,A593
483,BALLABIO,LC,4150,2104,2046,1030980040,097004,A594
484,BALLAO,SU,731,376,355,4201110030,111003,A597
485,BALME,TO,105,56,49,1010810190,001019,A599
486,BALMUCCIA,VC,110,50,60,1010880080,002008,A600
487,BALOCCO,VC,217,121,96,1010880090,002009,A601
488,BALSORANO,AQ,3262,1626,1636,3130380070,066007,A603
489,BALVANO,PZ,1742,898,844,3170640080,076008,A604
490,BALZOLA,AL,1261,624,637,1010020110,006011,A605
491,BANARI,SS,535,266,269,4200730070,090007,A606
492,BANCHETTE,TO,3085,1460,1625,1010810200,001020,A607
493,BANNIO ANZINO,VB,476,242,234,1011020070,103007,A610
494,BANZI,PZ,1195,609,586,3170640090,076009,A612
495,BAONE,PD,3067,1552,1515,1050540090,028009,A613
496,BARADILI,OR,76,38,38,4200950100,095010,A614
497,BARAGIANO,PZ,2534,1259,1275,3170640100,076010,A615
498,BARANELLO,CB,2496,1227,1269,3140190020,070002,A616
499,BARANO D'ISCHIA,,9975,4959,5016,3150510070,063007,A617
500,BARANZATE,MI,11762,6105,5657,1030490116,015250,A618
501,BARASSO,VA,1620,787,833,1030860062,012008,A619
502,BARATILI SAN PIETRO,OR,1211,598,613,4200950110,095011,A621
503,BARBANIA,TO,1570,782,788,1010810210,001021,A625
504,BARBARA,AN,1280,645,635,2110030040,042004,A626
505,BARBARANO MOSSANO,VI,6200,3071,3129,1050900112,024124,M401
506,BARBARANO ROMANO,VT,990,495,495,2120910040,056004,A628
507,BARBARESCO,CN,609,304,305,1010270110,004011,A629
508,BARBARIGA,BS,2317,1183,1134,1030150090,017011,A630
509,BARBATA,BG,687,350,337,1030120190,016019,A631
510,BARBERINO DI MUGELLO,FI,10884,5393,5491,2090300020,048002,A632
511,BARBERINO TAVARNELLE,FI,11906,5933,5973,2090300035,048054,M408
512,BARBIANELLO,PV,874,440,434,1030570080,018008,A634
513,BARBIANO/BARBIAN,BZ,1725,855,870,1040140040,021007,A635
514,BARBONA,PD,608,311,297,1050540100,028010,A637
515,BARCELLONA POZZO DI GOTTO,ME,40029,19456,20573,4190480050,083005,A638
516,BARCIS,PN,226,118,108,1060930060,093006,A640
517,BARD,AO,108,49,59,1020040090,007009,A643
518,BARDELLO CON MALGESSO E BREGANO,VA,3634,1780,1854,1030860071,012144,M433
519,BARDI,PR,2043,1034,1009,1080560020,034002,A646
520,BARDINETO,SV,748,359,389,1070740090,009009,A647
521,BARDOLINO,VR,7003,3397,3606,1050890060,023006,A650
522,BARDONECCHIA,TO,3044,1514,1530,1010810220,001022,A651
523,BAREGGIO,MI,17174,8416,8758,1030490120,015012,A652
524,BARENGO,NO,730,353,377,1010520110,003012,A653
525,BARESSA,OR,568,294,274,4200950120,095012,A655
526,BARETE,AQ,617,319,298,3130380080,066008,A656
527,BARGA,LU,9491,4652,4839,2090430030,046003,A657
528,BARGAGLI,GE,2558,1304,1254,1070340030,010003,A658
529,BARGE,CN,7430,3717,3713,1010270120,004012,A660
530,BARGHE,BS,1138,606,532,1030150091,017012,A661
531,BARI,BA,315948,151781,164167,3160090060,072006,A662
532,BARI SARDO,NU,3861,1867,1994,4200530050,091005,A663
533,BARIANO,BG,4252,2204,2048,1030120200,016020,A664
534,BARICELLA,BO,7021,3478,3543,1080130030,037003,A665
535,BARILE,PZ,2621,1284,1337,3170640110,076011,A666
536,BARISCIANO,AQ,1669,812,857,3130380090,066009,A667
537,BARLASSINA,MB,6873,3376,3497,1031040050,108005,A668
538,BARLETTA,BT,92798,46054,46744,3161060020,110002,A669
539,BARNI,CO,559,278,281,1030240150,013015,A670
540,BAROLO,CN,660,321,339,1010270130,004013,A671
541,BARONE CANAVESE,TO,556,269,287,1010810230,001023,A673
542,BARONISSI,SA,16798,8287,8511,3150720130,065013,A674
543,BARRAFRANCA,EN,12000,5664,6336,4190280040,086004,A676
544,BARRALI,SU,1095,562,533,4201110040,111004,A677
545,BARREA,AQ,718,356,362,3130380100,066010,A678
546,BARUMINI,SU,1176,591,585,4201110050,111005,A681
547,BARZAGO,LC,2406,1185,1221,1030980050,097005,A683
548,BARZANA,BG,2004,1038,966,1030120210,016021,A684
549,BARZANO',LC,4993,2448,2545,1030980060,097006,A686
550,BARZIO,LC,1260,613,647,1030980070,097007,A687
551,BASALUZZO,AL,2001,1010,991,1010020120,006012,A689
552,BASCAPE',PV,1779,942,837,1030570090,018009,A690
553,BASCHI,TR,2590,1266,1324,2100800070,055007,A691
554,BASCIANO,TE,2349,1181,1168,3130790040,067005,A692
555,BASELGA DI PINE',TN,5098,2582,2516,1040830100,022009,A694
556,BASELICE,BN,2121,1005,1116,3150110070,062007,A696
557,BASIANO,MI,3654,1833,1821,1030490140,015014,A697
558,BASICO',ME,532,257,275,4190480060,083006,A698
559,BASIGLIO,MI,8040,3881,4159,1030490150,015015,A699
560,BASILIANO,UD,5233,2599,2634,1060850090,030009,A700
561,BASSANO BRESCIANO,BS,2333,1196,1137,1030150100,017013,A702
562,BASSANO DEL GRAPPA,VI,42334,20239,22095,1050900120,024012,A703
563,BASSANO IN TEVERINA,VT,1251,625,626,2120910051,056006,A706
564,BASSANO ROMANO,VT,4627,2306,2321,2120910052,056005,A704
565,BASSIANO,LT,1461,749,712,2120400020,059002,A707
566,BASSIGNANA,AL,1556,763,793,1010020130,006013,A708
567,BASTIA MONDOVI',CN,628,313,315,1010270140,004014,A709
568,BASTIA UMBRA,PG,21256,10248,11008,2100580020,054002,A710
569,BASTIDA PANCARANA,PV,983,507,476,1030570110,018011,A712
570,BASTIGLIA,MO,4126,2060,2066,1080500010,036001,A713
571,BATTAGLIA TERME,PD,3782,1853,1929,1050540110,028011,A714
572,BATTIFOLLO,CN,211,117,94,1010270150,004015,A716
573,BATTIPAGLIA,SA,49655,24420,25235,3150720140,065014,A717
574,BATTUDA,PV,683,351,332,1030570120,018012,A718
575,BAUCINA,PA,1875,936,939,4190550080,082008,A719
576,BAULADU,OR,647,317,330,4200950130,095013,A721
577,BAUNEI,NU,3480,1716,1764,4200530060,091006,A722
578,BAVENO,VB,4742,2318,2424,1011020080,103008,A725
579,BEDERO VALCUVIA,VA,665,336,329,1030860080,012010,A728
580,BEDIZZOLE,BS,12278,6121,6157,1030150110,017014,A729
581,BEDOLLO,TN,1472,743,729,1040830110,022011,A730
582,BEDONIA,PR,3150,1540,1610,1080560030,034003,A731
583,BEDULITA,BG,705,343,362,1030120220,016022,A732
584,BEE,VB,758,353,405,1011020090,103009,A733
585,BEINASCO,TO,17464,8412,9052,1010810240,001024,A734
586,BEINETTE,CN,3441,1717,1724,1010270160,004016,A735
587,BELCASTRO,CZ,1227,629,598,3180220090,079009,A736
588,BELFIORE,VR,3271,1692,1579,1050890070,023007,A737
589,BELFORTE ALL'ISAURO,PU,749,371,378,2110590050,041005,A740
590,BELFORTE DEL CHIENTI,MC,1826,895,931,2110440040,043004,A739
591,BELFORTE MONFERRATO,AL,499,259,240,1010020140,006014,A738
592,BELGIOIOSO,PV,6301,3071,3230,1030570130,018013,A741
593,BELGIRATE,VB,498,238,260,1011020100,103010,A742
594,BELLA,PZ,4727,2365,2362,3170640120,076012,A743
595,BELLAGIO,CO,3577,1704,1873,1030240191,013250,M335
596,BELLANO,LC,3415,1683,1732,1030980080,097008,A745
597,BELLANTE,TE,6846,3373,3473,3130790050,067006,A746
598,BELLARIA-IGEA MARINA,RN,19495,9569,9926,1081010010,099001,A747
599,BELLEGRA,RM,2707,1323,1384,2120700120,058012,A749
600,BELLINO,CN,95,51,44,1010270170,004017,A750
601,BELLINZAGO LOMBARDO,MI,3809,1873,1936,1030490160,015016,A751
602,BELLINZAGO NOVARESE,NO,9444,4728,4716,1010520150,003016,A752
603,BELLIZZI,SA,13295,6544,6751,3150720141,065158,M294
604,BELLONA,CE,6039,2957,3082,3150200070,061007,A755
605,BELLOSGUARDO,SA,705,332,373,3150720150,065015,A756
606,BELLUNO,BL,35395,16900,18495,1050100060,025006,A757
607,BELLUSCO,MB,7370,3608,3762,1031040060,108006,A759
608,BELMONTE CALABRO,CS,1780,866,914,3180250130,078013,A762
609,BELMONTE CASTELLO,FR,693,359,334,2120330130,060013,A763
610,BELMONTE DEL SANNIO,IS,646,301,345,3140940040,094004,A761
611,BELMONTE IN SABINA,RI,645,320,325,2120690050,057005,A765
612,BELMONTE MEZZAGNO,PA,10948,5401,5547,4190550090,082009,A764
613,BELMONTE PICENO,FM,586,284,302,2111050030,109003,A760
614,BELPASSO,CT,27851,13856,13995,4190210070,087007,A766
615,BELSITO,CS,892,455,437,3180250140,078014,A768
616,BELVEDERE DI SPINELLO,KR,1973,956,1017,3180970010,101001,A772
617,BELVEDERE LANGHE,CN,337,161,176,1010270180,004018,A774
618,BELVEDERE MARITTIMO,CS,8903,4241,4662,3180250150,078015,A773
619,BELVEDERE OSTRENSE,AN,2096,1039,1057,2110030050,042005,A769
620,BELVEGLIO,AT,314,158,156,1010070080,005008,A770
621,BELVI',NU,560,288,272,4200530070,091007,A776
622,BEMA,SO,117,59,58,1030770060,014006,A777
623,BENE LARIO,CO,330,170,160,1030240210,013021,A778
624,BENE VAGIENNA,CN,3643,1846,1797,1010270190,004019,A779
625,BENESTARE,RC,2478,1252,1226,3180670080,080008,A780
626,BENETUTTI,SS,1726,847,879,4200730080,090008,A781
627,BENEVELLO,CN,467,231,236,1010270200,004020,A782
628,BENEVENTO,BN,56916,27177,29739,3150110080,062008,A783
629,BENNA,BI,1146,560,586,1010960030,096003,A784
630,BENTIVOGLIO,BO,5700,2832,2868,1080130050,037005,A785
631,BERBENNO,BG,2431,1190,1241,1030120230,016023,A786
632,BERBENNO DI VALTELLINA,SO,4078,2045,2033,1030770070,014007,A787
633,BERCETO,PR,1996,1047,949,1080560040,034004,A788
634,BERCHIDDA,SS,2634,1306,1328,4200730090,090009,A789
635,BEREGAZZO CON FIGLIARO,CO,2794,1357,1437,1030240220,013022,A791
636,BEREGUARDO,PV,2861,1432,1429,1030570140,018014,A792
637,BERGAMASCO,AL,709,343,366,1010020150,006015,A793
638,BERGAMO,BG,119476,56641,62835,1030120240,016024,A794
639,BERGANTINO,RO,2422,1193,1229,1050710060,029006,A795
640,BERGEGGI,SV,1068,520,548,1070740100,009010,A796
641,BERGOLO,CN,55,30,25,1010270210,004021,A798
642,BERLINGO,BS,2752,1427,1325,1030150120,017015,A799
643,BERNALDA,MT,11964,5977,5987,3170470030,077003,A801
644,BERNAREGGIO,MB,11385,5760,5625,1031040070,108007,A802
645,BERNATE TICINO,MI,2976,1473,1503,1030490190,015019,A804
646,BERNEZZO,CN,4219,2080,2139,1010270220,004022,A805
647,BERTINORO,FC,10984,5397,5587,1080320020,040003,A809
648,BERTIOLO,UD,2376,1166,1210,1060850100,030010,A810
649,BERTONICO,LO,1071,547,524,1030990020,098002,A811
650,BERZANO DI SAN PIETRO,AT,397,219,178,1010070090,005009,A812
651,BERZANO DI TORTONA,AL,157,76,81,1010020160,006016,A813
652,BERZO DEMO,BS,1525,789,736,1030150130,017016,A816
653,BERZO INFERIORE,BS,2447,1221,1226,1030150140,017017,A817
654,BERZO SAN FERMO,BG,1428,739,689,1030120250,016025,A815
655,BESANA IN BRIANZA,MB,15442,7626,7816,1031040080,108008,A818
656,BESANO,VA,2509,1247,1262,1030860081,012011,A819
657,BESATE,MI,2028,1024,1004,1030490220,015022,A820
658,BESENELLO,TN,2754,1385,1369,1040830130,022013,A821
659,BESENZONE,PC,938,469,469,1080610030,033003,A823
660,BESNATE,VA,5475,2685,2790,1030860090,012012,A825
661,BESOZZO,VA,8756,4226,4530,1030860100,012013,A826
662,BESSUDE,SS,391,186,205,4200730100,090010,A827
663,BETTOLA,PC,2608,1321,1287,1080610040,033004,A831
664,BETTONA,PG,4288,2074,2214,2100580030,054003,A832
665,BEURA-CARDEZZA,VB,1437,720,717,1011020110,103011,A834
666,BEVAGNA,PG,4777,2374,2403,2100580040,054004,A835
667,BEVERINO,SP,2264,1122,1142,1070390030,011003,A836
668,BEVILACQUA,VR,1771,894,877,1050890080,023008,A837
669,BIANCAVILLA,CT,23031,11164,11867,4190210080,087008,A841
670,BIANCHI,CS,1210,621,589,3180250160,078016,A842
671,BIANCO,RC,4188,2063,2125,3180670090,080009,A843
672,BIANDRATE,NO,1307,666,641,1010520170,003018,A844
673,BIANDRONNO,VA,3167,1549,1618,1030860110,012014,A845
674,BIANZANO,BG,602,305,297,1030120251,016026,A846
675,BIANZE',VC,1841,900,941,1010880110,002011,A847
676,BIANZONE,SO,1262,636,626,1030770080,014008,A848
677,BIASSONO,MB,12217,5885,6332,1031040090,108009,A849
678,BIBBIANO,RE,10183,5064,5119,1080680040,035004,A850
679,BIBBIENA,AR,11806,5860,5946,2090050040,051004,A851
680,BIBBONA,LI,3172,1609,1563,2090420010,049001,A852
681,BIBIANA,TO,3378,1696,1682,1010810250,001025,A853
682,BICCARI,FG,2640,1305,1335,3160310060,071006,A854
683,BICINICCO,UD,1811,895,916,1060850110,030011,A855
684,BIDONI',OR,128,64,64,4200950140,095014,A856
685,BIELLA,BI,42783,20202,22581,1010960040,096004,A859
686,BIENNO,BS,3760,1850,1910,1030150150,017018,A861
687,BIENO,TN,450,216,234,1040830150,022015,A863
688,BIENTINA,PI,8553,4152,4401,2090620020,050001,A864
689,BINAGO,CO,4824,2403,2421,1030240230,013023,A870
690,BINASCO,MI,7086,3369,3717,1030490240,015024,A872
691,BINETTO,BA,2138,1066,1072,3160090080,072008,A874
692,BIOGLIO,BI,905,469,436,1010960050,096005,A876
693,BIONAZ,AO,218,114,104,1020040100,007010,A877
694,BIONE,BS,1311,657,654,1030150160,017019,A878
695,BIRORI,NU,499,241,258,4200530080,091008,A880
696,BISACCIA,AV,3554,1777,1777,3150080110,064011,A881
697,BISACQUINO,PA,4190,2048,2142,4190550100,082010,A882
698,BISCEGLIE,BT,53738,26573,27165,3161060030,110003,A883
699,BISEGNA,AQ,207,95,112,3130380110,066011,A884
700,BISENTI,TE,1696,866,830,3130790060,067007,A885
701,BISIGNANO,CS,9614,4796,4818,3180250170,078017,A887
702,BISTAGNO,AL,1765,876,889,1010020170,006017,A889
703,BISUSCHIO,VA,4250,2071,2179,1030860120,012015,A891
704,BITETTO,BA,11794,5772,6022,3160090100,072010,A892
705,BITONTO,BA,53396,26302,27094,3160090110,072011,A893
706,BITRITTO,BA,11287,5545,5742,3160090120,072012,A894
707,BITTI,NU,2610,1269,1341,4200530090,091009,A895
708,BIVONA,AG,3257,1593,1664,4190010040,084004,A896
709,BIVONGI,RC,1163,562,601,3180670100,080010,A897
710,BIZZARONE,CO,1725,862,863,1030240240,013024,A898
711,BLEGGIO SUPERIORE,TN,1534,784,750,1040830170,022017,A902
712,BLELLO,BG,72,33,39,1030120260,016027,A903
713,BLERA,VT,3003,1480,1523,2120910060,056007,A857
714,BLESSAGNO,CO,290,152,138,1030240250,013025,A904
715,BLEVIO,CO,1091,519,572,1030240260,013026,A905
716,BLUFI,PA,893,423,470,4190550101,082082,M268
717,BOARA PISANI,PD,2393,1196,1197,1050540120,028012,A906
718,BOBBIO,PC,3417,1631,1786,1080610050,033005,A909
719,BOBBIO PELLICE,TO,539,259,280,1010810260,001026,A910
720,BOCA,NO,1131,559,572,1010520180,003019,A911
721,BOCCHIGLIERO,CS,1091,500,591,3180250180,078018,A912
722,BOCCIOLETO,VC,163,78,85,1010880140,002014,A914
723,BOCENAGO,TN,400,198,202,1040830180,022018,A916
724,BODIO LOMNAGO,VA,2231,1086,1145,1030860130,012016,A918
725,BOFFALORA D'ADDA,LO,1731,871,860,1030990030,098003,A919
726,BOFFALORA SOPRA TICINO,MI,4110,2042,2068,1030490260,015026,A920
727,BOGLIASCO,GE,4379,2101,2278,1070340040,010004,A922
728,BOGNANCO,VB,191,106,85,1011020120,103012,A925
729,BOGOGNO,NO,1297,637,660,1010520200,003021,A929
730,BOISSANO,SV,2527,1271,1256,1070740110,009011,A931
731,BOJANO,CB,7502,3657,3845,3140190030,070003,A930
732,BOLANO,SP,7451,3649,3802,1070390040,011004,A932
733,BOLGARE,BG,6521,3292,3229,1030120270,016028,A937
734,BOLLATE,MI,36166,17351,18815,1030490270,015027,A940
735,BOLLENGO,TO,2098,1065,1033,1010810270,001027,A941
736,BOLOGNA,BO,387842,184660,203182,1080130060,037006,A944
737,BOLOGNANO,PE,1024,509,515,3130600030,068003,A945
738,BOLOGNETTA,PA,4097,2023,2074,4190550110,082011,A946
739,BOLOGNOLA,MC,145,81,64,2110440050,043005,A947
740,BOLOTANA,NU,2419,1119,1300,4200530100,091010,A948
741,BOLSENA,VT,3739,1806,1933,2120910070,056008,A949
742,BOLTIERE,BG,6210,3168,3042,1030120280,016029,A950
743,BOLZANO NOVARESE,NO,1149,589,560,1010520210,003022,A953
744,BOLZANO VICENTINO,VI,6504,3229,3275,1050900130,024013,A954
745,BOLZANO/BOZEN,BZ,106601,51445,55156,1040140050,021008,A952
746,BOMARZO,VT,1692,859,833,2120910080,056009,A955
747,BOMBA,CH,727,367,360,3130230060,069006,A956
748,BOMPENSIERE,CL,513,258,255,4190180020,085002,A957
749,BOMPIETRO,PA,1224,583,641,4190550120,082012,A958
750,BOMPORTO,MO,10144,5104,5040,1080500020,036002,A959
751,BONARCADO,OR,1519,769,750,4200950150,095015,A960
752,BONASSOLA,SP,816,392,424,1070390050,011005,A961
753,BONATE SOPRA,BG,10242,5144,5098,1030120290,016030,A963
754,BONATE SOTTO,BG,6629,3317,3312,1030120300,016031,A962
755,BONAVIGO,VR,2010,1046,964,1050890090,023009,A964
756,BONDENO,FE,13872,6766,7106,1080290030,038003,A965
757,BONDONE,TN,643,328,315,1040830201,022021,A968
758,BONEA,BN,1383,699,684,3150110090,062009,A970
759,BONEFRO,CB,1214,586,628,3140190040,070004,A971
760,BONEMERSE,CR,1464,721,743,1030260060,019006,A972
761,BONIFATI,CS,2624,1260,1364,3180250190,078019,A973
762,BONITO,AV,2242,1114,1128,3150080120,064012,A975
763,BONNANARO,SS,930,444,486,4200730110,090011,A976
764,BONO,SS,3356,1651,1705,4200730120,090012,A977
765,BONORVA,SS,3231,1633,1598,4200730130,090013,A978
766,BONVICINO,CN,100,47,53,1010270230,004023,A979
767,BORBONA,RI,589,307,282,2120690060,057006,A981
768,BORCA DI CADORE,BL,826,417,409,1050100070,025007,A982
769,BORDANO,UD,710,351,359,1060850120,030012,A983
770,BORDIGHERA,IM,10130,4735,5395,1070370070,008008,A984
771,BORDOLANO,CR,563,287,276,1030260070,019007,A986
772,BORE,PR,676,351,325,1080560050,034005,A987
773,BORETTO,RE,5252,2602,2650,1080680050,035005,A988
774,BORGARELLO,PV,2662,1303,1359,1030570141,018015,A989
775,BORGARO TORINESE,TO,11827,5734,6093,1010810280,001028,A990
776,BORGETTO,PA,7134,3533,3601,4190550130,082013,A991
777,BORGHETTO D'ARROSCIA,IM,408,219,189,1070370080,008009,A993
778,BORGHETTO DI BORBERA,AL,1924,977,947,1010020180,006018,A998
779,BORGHETTO DI VARA,SP,878,432,446,1070390060,011006,A992
780,BORGHETTO LODIGIANO,LO,4288,2164,2124,1030990040,098004,A995
781,BORGHETTO SANTO SPIRITO,SV,4612,2193,2419,1070740120,009012,A999
782,BORGHI,FC,2882,1444,1438,1080320030,040004,B001
783,BORGIA,CZ,7218,3519,3699,3180220110,079011,B002
784,BORGIALLO,TO,582,287,295,1010810290,001029,B003
785,BORGIO VEREZZI,SV,2086,980,1106,1070740130,009013,B005
786,BORGO A MOZZANO,LU,6667,3293,3374,2090430040,046004,B007
787,BORGO CHIESE,TN,1954,990,964,1040830204,022238,M352
788,BORGO D'ALE,VC,2223,1108,1115,1010880150,002015,B009
789,BORGO D'ANAUNIA,TN,2504,1248,1256,1040830205,022252,M429
790,BORGO DI TERZO,BG,1147,578,569,1030120310,016032,B010
791,BORGO LARES,TN,720,378,342,1040830207,022239,M353
792,BORGO MANTOVANO,MN,5319,2571,2748,1030450048,020072,M396
793,BORGO PACE,PU,532,273,259,2110590060,041006,B026
794,BORGO PRIOLO,PV,1319,677,642,1030570150,018016,B028
795,BORGO SAN DALMAZZO,CN,12477,6163,6314,1010270250,004025,B033
796,BORGO SAN GIACOMO,BS,5388,2749,2639,1030150170,017020,B035
797,BORGO SAN GIOVANNI,LO,2435,1227,1208,1030990050,098005,B017
798,BORGO SAN LORENZO,FI,18184,8832,9352,2090300040,048004,B036
799,BORGO SAN MARTINO,AL,1343,672,671,1010020200,006020,B037
800,BORGO SAN SIRO,PV,953,481,472,1030570170,018018,B038
801,BORGO TICINO,NO,5174,2601,2573,1010520240,003025,B043
802,BORGO TOSSIGNANO,BO,3240,1614,1626,1080130070,037007,B044
803,BORGO VAL DI TARO,PR,6723,3285,3438,1080560060,034006,B042
804,BORGO VALBELLUNA,BL,13457,6622,6835,1050100075,025074,M421
805,BORGO VALSUGANA,TN,6978,3425,3553,1040830210,022022,B006
806,BORGO VELINO,RI,940,447,493,2120690071,057008,A996
807,BORGO VENETO,PD,7053,3513,3540,1050540125,028107,M402
808,BORGO VERCELLI,VC,2260,1109,1151,1010880170,002017,B046
809,BORGO VIRGILIO,MN,14778,7323,7455,1030450065,020071,M340
810,BORGOCARBONARA,MN,1901,950,951,1030450055,020073,M406
811,BORGOFRANCO D'IVREA,TO,3555,1707,1848,1010810300,001030,B015
812,BORGOLAVEZZARO,NO,1956,942,1014,1010520220,003023,B016
813,BORGOMALE,CN,386,184,202,1010270240,004024,B018
814,BORGOMANERO,NO,21277,10245,11032,1010520230,003024,B019
815,BORGOMARO,IM,827,430,397,1070370090,008010,B020
816,BORGOMASINO,TO,773,373,400,1010810310,001031,B021
817,BORGOMEZZAVALLE,VB,292,142,150,1011020125,103078,M370
818,BORGONE SUSA,TO,2151,1084,1067,1010810320,001032,B024
819,BORGONOVO VAL TIDONE,PC,8026,4022,4004,1080610060,033006,B025
820,BORGORATTO ALESSANDRINO,AL,536,253,283,1010020190,006019,B029
821,BORGORATTO MORMOROLO,PV,417,203,214,1030570160,018017,B030
822,BORGORICCO,PD,8906,4486,4420,1050540130,028013,B031
823,BORGOROSE,RI,4247,2194,2053,2120690072,057007,B008
824,BORGOSATOLLO,BS,9061,4544,4517,1030150180,017021,B040
825,BORGOSESIA,VC,12189,5795,6394,1010880160,002016,B041
826,BORMIDA,SV,343,174,169,1070740140,009014,B048
827,BORMIO,SO,3990,1953,2037,1030770090,014009,B049
828,BORNASCO,PV,2671,1359,1312,1030570180,018019,B051
829,BORNO,BS,2479,1210,1269,1030150190,017022,B054
830,BORONEDDU,OR,154,71,83,4200950160,095016,B055
831,BORORE,NU,1994,973,1021,4200530110,091011,B056
832,BORRELLO,CH,306,152,154,3130230070,069007,B057
833,BORRIANA,BI,861,408,453,1010960060,096006,B058
834,BORSO DEL GRAPPA,TV,5878,2939,2939,1050840040,026004,B061
835,BORTIGALI,NU,1205,577,628,4200530120,091012,B062
836,BORTIGIADAS,SS,729,361,368,4200730140,090014,B063
837,BORUTTA,SS,260,124,136,4200730150,090015,B064
838,BORZONASCA,GE,1834,943,891,1070340050,010005,B067
839,BOSA,OR,7539,3676,3863,4200950166,095079,B068
840,BOSARO,RO,1451,723,728,1050710070,029007,B069
841,BOSCHI SANT'ANNA,VR,1361,669,692,1050890100,023010,B070
842,BOSCO CHIESANUOVA,VR,3560,1901,1659,1050890110,023011,B073
843,BOSCO MARENGO,AL,2241,1146,1095,1010020210,006021,B071
844,BOSCONERO,TO,3066,1517,1549,1010810330,001033,B075
845,BOSCOREALE,,26317,12985,13332,3150510080,063008,B076
846,BOSCOTRECASE,,9897,4847,5050,3150510090,063009,B077
847,BOSIA,CN,170,83,87,1010270260,004026,B079
848,BOSIO,AL,1062,554,508,1010020220,006022,B080
849,BOSISIO PARINI,LC,3312,1671,1641,1030980090,097009,B081
850,BOSNASCO,PV,636,326,310,1030570190,018020,B082
851,BOSSICO,BG,976,496,480,1030120320,016033,B083
852,BOSSOLASCO,CN,639,306,333,1010270270,004027,B084
853,BOTRICELLO,CZ,5026,2483,2543,3180220111,079012,B085
854,BOTRUGNO,LE,2613,1226,1387,3160410081,075009,B086
855,BOTTANUCO,BG,5040,2539,2501,1030120330,016034,B088
856,BOTTICINO,BS,10706,5221,5485,1030150200,017023,B091
857,BOTTIDDA,SS,651,324,327,4200730160,090016,B094
858,BOVA,RC,400,217,183,3180670110,080011,B097
859,BOVA MARINA,RC,4080,2023,2057,3180670130,080013,B099
860,BOVALINO,RC,8672,4179,4493,3180670120,080012,B098
861,BOVEGNO,BS,2025,989,1036,1030150210,017024,B100
862,BOVES,CN,9641,4787,4854,1010270280,004028,B101
863,BOVEZZO,BS,7356,3554,3802,1030150220,017025,B102
864,BOVILLE ERNICA,FR,8423,4190,4233,2120330140,060014,A720
865,BOVINO,FG,2998,1464,1534,3160310070,071007,B104
866,BOVISIO-MASCIAGO,MB,16756,8194,8562,1031040100,108010,B105
867,BOVOLENTA,PD,3449,1731,1718,1050540140,028014,B106
868,BOVOLONE,VR,16031,7963,8068,1050890120,023012,B107
869,BOZZOLE,AL,311,165,146,1010020230,006023,B109
870,BOZZOLO,MN,4054,1988,2066,1030450070,020007,B110
871,BRA,CN,29536,14344,15192,1010270290,004029,B111
872,BRACCA,BG,724,366,358,1030120331,016035,B112
873,BRACCIANO,RM,18543,8944,9599,2120700130,058013,B114
874,BRACIGLIANO,SA,5336,2671,2665,3150720160,065016,B115
875,BRAIES/PRAGS,BZ,691,342,349,1040140060,021009,B116
876,BRALLO DI PREGOLA,PV,514,271,243,1030570191,018021,B117
877,BRANCALEONE,RC,3282,1607,1675,3180670140,080014,B118
878,BRANDICO,BS,1744,905,839,1030150230,017026,B120
879,BRANDIZZO,TO,8701,4266,4435,1010810340,001034,B121
880,BRANZI,BG,667,333,334,1030120350,016036,B123
881,BRAONE,BS,682,346,336,1030150240,017027,B124
882,BREBBIA,VA,3155,1556,1599,1030860140,012017,B126
883,BREDA DI PIAVE,TV,7659,3831,3828,1050840050,026005,B128
884,BREGANZE,VI,8381,4090,4291,1050900140,024014,B132
885,BREGNANO,CO,6384,3229,3155,1030240280,013028,B134
886,BREMBATE,BG,8513,4298,4215,1030120360,016037,B137
887,BREMBATE DI SOPRA,BG,7920,3939,3981,1030120370,016038,B138
888,BREMBIO,LO,2692,1387,1305,1030990060,098006,B141
889,BREME,PV,715,352,363,1030570200,018022,B142
890,BRENDOLA,VI,6639,3304,3335,1050900150,024015,B143
891,BRENNA,CO,2177,1107,1070,1030240290,013029,B144
892,BRENNERO/BRENNER,BZ,2308,1212,1096,1040140070,021010,B145
893,BRENO,BS,4632,2262,2370,1030150250,017028,B149
894,BRENTA,VA,1735,856,879,1030860151,012019,B150
895,BRENTINO BELLUNO,VR,1350,692,658,1050890130,023013,B152
896,BRENTONICO,TN,4042,2012,2030,1040830240,022025,B153
897,BRENZONE SUL GARDA,VR,2456,1146,1310,1050890140,023014,B154
898,BRESCELLO,RE,5623,2832,2791,1080680060,035006,B156
899,BRESCIA,BS,195906,94052,101854,1030150260,017029,B157
900,BRESIMO,TN,250,126,124,1040830250,022026,B158
901,BRESSANA BOTTARONE,PV,3443,1696,1747,1030570210,018023,B159
902,BRESSANONE/BRIXEN,BZ,22728,11085,11643,1040140080,021011,B160
903,BRESSANVIDO,VI,3167,1586,1581,1050900160,024016,B161
904,BRESSO,MI,26081,12677,13404,1030490320,015032,B162
905,BREZZO DI BEDERO,VA,1246,654,592,1030860152,012020,B166
906,BRIAGLIA,CN,305,160,145,1010270300,004030,B167
907,BRIATICO,VV,3781,1960,1821,3181030030,102003,B169
908,BRICHERASIO,TO,4616,2301,2315,1010810350,001035,B171
909,BRIENNO,CO,335,161,174,1030240300,013030,B172
910,BRIENZA,PZ,3855,1919,1936,3170640130,076013,B173
911,BRIGA ALTA,CN,40,28,12,1010270310,004031,B175
912,BRIGA NOVARESE,NO,2763,1333,1430,1010520250,003026,B176
913,BRIGNANO FRASCATA,AL,426,219,207,1010020240,006024,B179
914,BRIGNANO GERA D'ADDA,BG,6098,3033,3065,1030120390,016040,B178
915,BRINDISI,BR,83317,40026,43291,3160160010,074001,B180
916,BRINDISI MONTAGNA,PZ,811,421,390,3170640140,076014,B181
917,BRINZIO,VA,773,402,371,1030860160,012021,B182
918,BRIONA,NO,1105,535,570,1010520260,003027,B183
919,BRIONE,BS,737,393,344,1030150270,017030,B184
920,BRIOSCO,MB,6091,3023,3068,1031040110,108011,B187
921,BRISIGHELLA,RA,7189,3593,3596,1080660040,039004,B188
922,BRISSAGO-VALTRAVAGLIA,VA,1245,610,635,1030860170,012022,B191
923,BRISSOGNE,AO,948,490,458,1020040110,007011,B192
924,BRITTOLI,PE,266,133,133,3130600040,068004,B193
925,BRIVIO,LC,4459,2248,2211,1030980100,097010,B194
926,BROCCOSTELLA,FR,2684,1322,1362,2120330150,060015,B195
927,BROGLIANO,VI,4015,2033,1982,1050900170,024017,B196
928,BROGNATURO,VV,668,359,309,3181030040,102004,B197
929,BROLO,ME,5753,2743,3010,4190480070,083007,B198
930,BRONDELLO,CN,261,143,118,1010270320,004032,B200
931,BRONI,PV,9585,4598,4987,1030570220,018024,B201
932,BRONTE,CT,18307,8798,9509,4190210090,087009,B202
933,BRONZOLO/BRANZOLL,BZ,2758,1372,1386,1040140090,021012,B203
934,BROSSASCO,CN,1005,504,501,1010270330,004033,B204
935,BROSSO,TO,394,189,205,1010810360,001036,B205
936,BROVELLO-CARPUGNINO,VB,774,395,379,1011020130,103013,B207
937,BROZOLO,TO,454,240,214,1010810370,001037,B209
938,BRUGHERIO,MB,34870,16971,17899,1031040120,108012,B212
939,BRUGINE,PD,7147,3519,3628,1050540150,028015,B213
940,BRUGNATO,SP,1284,634,650,1070390070,011007,B214
941,BRUGNERA,PN,9268,4669,4599,1060930070,093007,B215
942,BRUINO,TO,8489,4161,4328,1010810380,001038,B216
943,BRUMANO,BG,122,69,53,1030120400,016041,B217
944,BRUNATE,CO,1623,812,811,1030240320,013032,B218
945,BRUNELLO,VA,929,457,472,1030860171,012023,B219
946,BRUNICO/BRUNECK,BZ,16995,8436,8559,1040140100,021013,B220
947,BRUNO,AT,297,144,153,1010070100,005010,B221
948,BRUSAPORTO,BG,5632,2790,2842,1030120401,016042,B223
949,BRUSASCO,TO,1490,756,734,1010810390,001039,B225
950,BRUSCIANO,,15889,7802,8087,3150510100,063010,B227
951,BRUSIMPIANO,VA,1170,584,586,1030860180,012024,B228
952,BRUSNENGO,BI,1975,967,1008,1010960070,096007,B229
953,BRUSSON,AO,861,422,439,1020040120,007012,B230
954,BRUZOLO,TO,1492,739,753,1010810400,001040,B232
955,BRUZZANO ZEFFIRIO,RC,1056,501,555,3180670150,080015,B234
956,BUBBIANO,MI,2460,1240,1220,1030490350,015035,B235
957,BUBBIO,AT,802,384,418,1010070110,005011,B236
958,BUCCHERI,SR,1765,831,934,4190760030,089003,B237
959,BUCCHIANICO,CH,4980,2444,2536,3130230080,069008,B238
960,BUCCIANO,BN,2000,985,1015,3150110100,062010,B239
961,BUCCINASCO,MI,26912,13065,13847,1030490360,015036,B240
962,BUCCINO,SA,4661,2305,2356,3150720170,065017,B242
963,BUCINE,AR,9910,4861,5049,2090050050,051005,B243
964,BUDDUSO',SS,3659,1843,1816,4200730170,090017,B246
965,BUDOIA,PN,2492,1249,1243,1060930080,093008,B247
966,BUDONI,SS,5333,2647,2686,4200730175,090091,B248
967,BUDRIO,BO,18294,8976,9318,1080130080,037008,B249
968,BUGGERRU,SU,1053,537,516,4201110060,111006,B250
969,BUGGIANO,PT,8746,4223,4523,2090630030,047003,B251
970,BUGLIO IN MONTE,SO,1967,990,977,1030770100,014010,B255
971,BUGNARA,AQ,1034,514,520,3130380120,066012,B256
972,BUGUGGIATE,VA,3075,1494,1581,1030860181,012025,B258
973,BUJA,UD,6337,3069,3268,1060850130,030013,B259
974,BULCIAGO,LC,2866,1458,1408,1030980110,097011,B261
975,BULGAROGRASSO,CO,4002,2016,1986,1030240340,013034,B262
976,BULTEI,SS,841,413,428,4200730180,090018,B264
977,BULZI,SS,470,251,219,4200730190,090019,B265
978,BUONABITACOLO,SA,2416,1185,1231,3150720180,065018,B266
979,BUONALBERGO,BN,1562,779,783,3150110110,062011,B267
980,BUONCONVENTO,SI,3004,1455,1549,2090750030,052003,B269
981,BUONVICINO,CS,2048,990,1058,3180250200,078020,B270
982,BURAGO DI MOLGORA,MB,4206,2037,2169,1031040130,108013,B272
983,BURCEI,SU,2666,1348,1318,4201110070,111007,B274
984,BURGIO,AG,2509,1222,1287,4190010050,084005,B275
985,BURGOS,SS,856,427,429,4200730200,090020,B276
986,BURIASCO,TO,1337,655,682,1010810410,001041,B278
987,BUROLO,TO,1105,523,582,1010810420,001042,B279
988,BURONZO,VC,851,418,433,1010880210,002021,B280
989,BUSACHI,OR,1172,567,605,4200950170,095017,B281
990,BUSALLA,GE,5168,2540,2628,1070340060,010006,B282
991,BUSANO,TO,1622,838,784,1010810430,001043,B284
992,BUSCA,CN,10127,5110,5017,1010270340,004034,B285
993,BUSCATE,MI,4633,2284,2349,1030490380,015038,B286
994,BUSCEMI,SR,968,491,477,4190760040,089004,B287
995,BUSETO PALIZZOLO,TP,2805,1361,1444,4190820020,081002,B288
996,BUSNAGO,MB,6764,3351,3413,1031040135,108051,B289
997,BUSSERO,MI,8341,4019,4322,1030490400,015040,B292
998,BUSSETO,PR,6767,3386,3381,1080560070,034007,B293
999,BUSSI SUL TIRINO,PE,2296,1127,1169,3130600050,068005,B294
1000,BUSSO,CB,1170,587,583,3140190050,070005,B295
1001,BUSSOLENGO,VR,20663,10133,10530,1050890150,023015,B296
1002,BUSSOLENO,TO,5652,2726,2926,1010810440,001044,B297
1003,BUSTO ARSIZIO,VA,82754,39878,42876,1030860190,012026,B300
1004,BUSTO GAROLFO,MI,14043,7010,7033,1030490410,015041,B301
1005,BUTERA,CL,4199,2054,2145,4190180030,085003,B302
1006,BUTI,PI,5575,2739,2836,2090620030,050002,B303
1007,BUTTAPIETRA,VR,6987,3521,3466,1050890160,023016,B304
1008,BUTTIGLIERA ALTA,TO,6304,3091,3213,1010810450,001045,B305
1009,BUTTIGLIERA D'ASTI,AT,2496,1260,1236,1010070120,005012,B306
1010,BUTTRIO,UD,3878,1923,1955,1060850140,030014,B309
1011,CABELLA LIGURE,AL,468,244,224,1010020250,006025,B311
1012,CABIATE,CO,7405,3703,3702,1030240350,013035,B313
1013,CABRAS,OR,8809,4377,4432,4200950180,095018,B314
1014,CACCAMO,PA,7747,3825,3922,4190550140,082014,B315
1015,CACCURI,KR,1553,759,794,3180970020,101002,B319
1016,CADEGLIANO-VICONAGO,VA,2131,1029,1102,1030860200,012027,B326
1017,CADELBOSCO DI SOPRA,RE,10638,5278,5360,1080680080,035008,B328
1018,CADEO,PC,5983,2958,3025,1080610070,033007,B332
1019,CADERZONE TERME,TN,700,353,347,1040830280,022029,B335
1020,CADONEGHE,PD,15773,7628,8145,1050540160,028016,B345
1021,CADORAGO,CO,7931,3950,3981,1030240360,013036,B346
1022,CADREZZATE CON OSMATE,VA,2651,1297,1354,1030860211,012143,M425
1023,CAERANO DI SAN MARCO,TV,7849,3862,3987,1050840060,026006,B349
1024,CAFASSE,TO,3310,1655,1655,1010810460,001046,B350
1025,CAGGIANO,SA,2548,1265,1283,3150720190,065019,B351
1026,CAGLI,PU,8068,3912,4156,2110590070,041007,B352
1027,CAGLIARI,CA,149092,69339,79753,4200170090,092009,B354
1028,CAGLIO,CO,475,230,245,1030240370,013037,B355
1029,CAGNANO AMITERNO,AQ,1152,571,581,3130380130,066013,B358
1030,CAGNANO VARANO,FG,6648,3271,3377,3160310080,071008,B357
1031,CAIANELLO,CE,1761,857,904,3150200080,061008,B361
1032,CAIAZZO,CE,5224,2563,2661,3150200090,061009,B362
1033,CAINES/KUENS,BZ,388,192,196,1040140110,021014,B364
1034,CAINO,BS,2136,1086,1050,1030150271,017031,B365
1035,CAIOLO,SO,1048,527,521,1030770110,014011,B366
1036,CAIRANO,AV,275,134,141,3150080130,064013,B367
1037,CAIRATE,VA,7729,3827,3902,1030860220,012029,B368
1038,CAIRO MONTENOTTE,SV,12648,6231,6417,1070740150,009015,B369
1039,CAIVANO,,36048,17804,18244,3150510110,063011,B371
1040,CALABRITTO,AV,2185,1075,1110,3150080140,064014,B374
1041,CALALZO DI CADORE,BL,1857,908,949,1050100080,025008,B375
1042,CALAMANDRANA,AT,1661,815,846,1010070130,005013,B376
1043,CALAMONACI,AG,1184,584,600,4190010060,084006,B377
1044,CALANGIANUS,SS,3853,1925,1928,4200730210,090021,B378
1045,CALANNA,RC,782,375,407,3180670160,080016,B379
1046,CALASCA-CASTIGLIONE,VB,567,286,281,1011020140,103014,B380
1047,CALASCIBETTA,EN,4166,2026,2140,4190280050,086005,B381
1048,CALASCIO,AQ,133,68,65,3130380140,066014,B382
1049,CALASETTA,SU,2802,1406,1396,4201110080,111008,B383
1050,CALATABIANO,CT,5167,2563,2604,4190210100,087010,B384
1051,CALATAFIMI SEGESTA,TP,6243,3061,3182,4190820030,081003,B385
1052,CALCATA,VT,915,442,473,2120910090,056010,B388
1053,CALCERANICA AL LAGO,TN,1386,688,698,1040830300,022032,B389
1054,CALCI,PI,6293,3029,3264,2090620040,050003,B390
1055,CALCIANO,MT,667,336,331,3170470040,077004,B391
1056,CALCINAIA,PI,12711,6212,6499,2090620050,050004,B392
1057,CALCINATE,BG,6089,3161,2928,1030120410,016043,B393
1058,CALCINATO,BS,12890,6534,6356,1030150280,017032,B394
1059,CALCIO,BG,5386,2788,2598,1030120420,016044,B395
1060,CALCO,LC,5333,2662,2671,1030980120,097012,B396
1061,CALDARO SULLA STRADA DEL VINO/KALTERN AN DER WEINSTRASSE,BZ,8107,3987,4120,1040140120,021015,B397
1062,CALDAROLA,MC,1639,814,825,2110440060,043006,B398
1063,CALDERARA DI RENO,BO,13434,6612,6822,1080130090,037009,B399
1064,CALDES,TN,1087,539,548,1040830310,022033,B400
1065,CALDIERO,VR,7896,4009,3887,1050890170,023017,B402
1066,CALDOGNO,VI,11321,5546,5775,1050900180,024018,B403
1067,CALDONAZZO,TN,3900,1906,1994,1040830320,022034,B404
1068,CALENDASCO,PC,2397,1218,1179,1080610080,033008,B405
1069,CALENZANO,FI,18041,8886,9155,2090300050,048005,B406
1070,CALESTANO,PR,2060,1082,978,1080560080,034008,B408
1071,CALICE AL CORNOVIGLIO,SP,1053,534,519,1070390080,011008,B410
1072,CALICE LIGURE,SV,1692,834,858,1070740160,009016,B409
1073,CALIMERA,LE,6777,3165,3612,3160410090,075010,B413
1074,CALITRI,AV,4278,2059,2219,3150080150,064015,B415
1075,CALIZZANO,SV,1423,695,728,1070740170,009017,B416
1076,CALLABIANA,BI,147,79,68,1010960080,096008,B417
1077,CALLIANO,TN,2020,1022,998,1040830330,022035,B419
1078,CALLIANO MONFERRATO,AT,1209,600,609,1010070140,005014,B418
1079,CALOLZIOCORTE,LC,13507,6597,6910,1030980130,097013,B423
1080,CALOPEZZATI,CS,1301,655,646,3180250210,078021,B424
1081,CALOSSO,AT,1146,593,553,1010070150,005015,B425
1082,CALOVETO,CS,1131,557,574,3180250220,078022,B426
1083,CALTABELLOTTA,AG,3238,1538,1700,4190010070,084007,B427
1084,CALTAGIRONE,CT,36058,17622,18436,4190210110,087011,B428
1085,CALTANISSETTA,CL,59245,28633,30612,4190180040,085004,B429
1086,CALTAVUTURO,PA,3612,1751,1861,4190550150,082015,B430
1087,CALTIGNAGA,NO,2504,1239,1265,1010520290,003030,B431
1088,CALTO,RO,659,324,335,1050710080,029008,B432
1089,CALTRANO,VI,2527,1262,1265,1050900190,024019,B433
1090,CALUSCO D'ADDA,BG,8231,4094,4137,1030120440,016046,B434
1091,CALUSO,TO,7388,3586,3802,1010810470,001047,B435
1092,CALVAGESE DELLA RIVIERA,BS,3644,1827,1817,1030150290,017033,B436
1093,CALVANICO,SA,1397,700,697,3150720200,065020,B437
1094,CALVATONE,CR,1174,607,567,1030260090,019009,B439
1095,CALVELLO,PZ,1764,848,916,3170640150,076015,B440
1096,CALVENE,VI,1289,642,647,1050900200,024020,B441
1097,CALVENZANO,BG,4279,2136,2143,1030120450,016047,B442
1098,CALVERA,PZ,358,181,177,3170640160,076016,B443
1099,CALVI,BN,2515,1241,1274,3150110120,062012,B444
1100,CALVI DELL'UMBRIA,TR,1697,829,868,2100800080,055008,B446
1101,CALVI RISORTA,CE,5518,2650,2868,3150200100,061010,B445
1102,CALVIGNANO,PV,106,54,52,1030570230,018025,B447
1103,CALVIGNASCO,MI,1222,608,614,1030490420,015042,B448
1104,CALVISANO,BS,8375,4268,4107,1030150300,017034,B450
1105,CALVIZZANO,,12397,6103,6294,3150510120,063012,B452
1106,CAMAGNA MONFERRATO,AL,468,227,241,1010020260,006026,B453
1107,CAMAIORE,LU,31821,15381,16440,2090430050,046005,B455
1108,CAMANDONA,BI,311,155,156,1010960090,096009,B457
1109,CAMASTRA,AG,1947,952,995,4190010080,084008,B460
1110,CAMBIAGO,MI,7118,3581,3537,1030490440,015044,B461
1111,CAMBIANO,TO,5900,2835,3065,1010810480,001048,B462
1112,CAMBIASCA,VB,1568,761,807,1011020150,103015,B463
1113,CAMBURZANO,BI,1120,536,584,1010960100,096010,B465
1114,CAMERANA,CN,575,291,284,1010270350,004035,B467
1115,CAMERANO,AN,7107,3469,3638,2110030060,042006,B468
1116,CAMERANO CASASCO,AT,407,205,202,1010070160,005016,B469
1117,CAMERATA CORNELLO,BG,558,272,286,1030120460,016048,B471
1118,CAMERATA NUOVA,RM,410,213,197,2120700140,058014,B472
1119,CAMERATA PICENA,AN,2506,1258,1248,2110030070,042007,B470
1120,CAMERI,NO,10660,5196,5464,1010520310,003032,B473
1121,CAMERINO,MC,6268,3064,3204,2110440070,043007,B474
1122,CAMEROTA,SA,6882,3430,3452,3150720210,065021,B476
1123,CAMIGLIANO,CE,1993,1004,989,3150200110,061011,B477
1124,CAMINI,RC,808,383,425,3180670170,080017,B481
1125,CAMINO,AL,736,381,355,1010020270,006027,B482
1126,CAMINO AL TAGLIAMENTO,UD,1544,759,785,1060850150,030015,B483
1127,CAMISANO,CR,1237,614,623,1030260100,019010,B484
1128,CAMISANO VICENTINO,VI,11165,5525,5640,1050900210,024021,B485
1129,CAMMARATA,AG,5920,2955,2965,4190010090,084009,B486
1130,CAMOGLI,GE,5022,2442,2580,1070340070,010007,B490
1131,CAMPAGNA,SA,16562,8315,8247,3150720220,065022,B492
1132,CAMPAGNA LUPIA,VE,7128,3527,3601,1050870020,027002,B493
1133,CAMPAGNANO DI ROMA,RM,11092,5340,5752,2120700150,058015,B496
1134,CAMPAGNATICO,GR,2335,1196,1139,2090360020,053002,B497
1135,CAMPAGNOLA CREMASCA,CR,662,325,337,1030260101,019011,B498
1136,CAMPAGNOLA EMILIA,RE,5500,2749,2751,1080680090,035009,B499
1137,CAMPANA,CS,1509,733,776,3180250230,078023,B500
1138,CAMPARADA,MB,2156,1129,1027,1031040140,108014,B501
1139,CAMPEGINE,RE,5292,2619,2673,1080680100,035010,B502
1140,CAMPELLO SUL CLITUNNO,PG,2347,1149,1198,2100580050,054005,B504
1141,CAMPERTOGNO,VC,221,110,111,1010880250,002025,B505
1142,CAMPI BISENZIO,FI,47541,23569,23972,2090300060,048006,B507
1143,CAMPI SALENTINA,LE,9885,4735,5150,3160410100,075011,B506
1144,CAMPIGLIA CERVO,BI,521,266,255,1010960111,096086,M373
1145,CAMPIGLIA DEI BERICI,VI,1669,838,831,1050900220,024022,B511
1146,CAMPIGLIA MARITTIMA,LI,12538,6030,6508,2090420020,049002,B509
1147,CAMPIGLIONE FENILE,TO,1330,657,673,1010810490,001049,B512
1148,CAMPIONE D'ITALIA,CO,1748,830,918,1030240390,013040,B513
1149,CAMPITELLO DI FASSA,TN,707,346,361,1040830331,022036,B514
1150,CAMPLI,TE,6630,3314,3316,3130790070,067008,B515
1151,CAMPO CALABRO,RC,4449,2179,2270,3180670180,080018,B516
1152,CAMPO DI GIOVE,AQ,750,381,369,3130380150,066015,B526
1153,CAMPO DI TRENS/FREIENFELD,BZ,2679,1388,1291,1040140130,021016,B529
1154,CAMPO LIGURE,GE,2790,1415,1375,1070340080,010008,B538
1155,CAMPO NELL'ELBA,LI,4706,2328,2378,2090420030,049003,B553
1156,CAMPO SAN MARTINO,PD,5652,2847,2805,1050540200,028020,B564
1157,CAMPO TURES/SAND IN TAUFERS,BZ,5685,2818,2867,1040140140,021017,B570
1158,CAMPOBASSO,CB,47587,22888,24699,3140190060,070006,B519
1159,CAMPOBELLO DI LICATA,AG,9175,4468,4707,4190010100,084010,B520
1160,CAMPOBELLO DI MAZARA,TP,11463,5727,5736,4190820040,081004,B521
1161,CAMPOCHIARO,CB,595,289,306,3140190070,070007,B522
1162,CAMPODARSEGO,PD,14943,7363,7580,1050540170,028017,B524
1163,CAMPODENNO,TN,1512,779,733,1040830340,022037,B525
1164,CAMPODIMELE,LT,561,296,265,2120400030,059003,B527
1165,CAMPODIPIETRA,CB,2435,1180,1255,3140190080,070008,B528
1166,CAMPODOLCINO,SO,928,466,462,1030770120,014012,B530
1167,CAMPODORO,PD,2616,1311,1305,1050540180,028018,B531
1168,CAMPOFELICE DI FITALIA,PA,467,241,226,4190550151,082016,B533
1169,CAMPOFELICE DI ROCCELLA,PA,7605,3776,3829,4190550160,082017,B532
1170,CAMPOFILONE,FM,1910,964,946,2111050040,109004,B534
1171,CAMPOFIORITO,PA,1179,579,600,4190550170,082018,B535
1172,CAMPOFORMIDO,UD,7857,3850,4007,1060850160,030016,B536
1173,CAMPOFRANCO,CL,2716,1281,1435,4190180050,085005,B537
1174,CAMPOGALLIANO,MO,8578,4226,4352,1080500030,036003,B539
1175,CAMPOLATTARO,BN,972,484,488,3150110130,062013,B541
1176,CAMPOLI APPENNINO,FR,1610,802,808,2120330160,060016,B543
1177,CAMPOLI DEL MONTE TABURNO,BN,1594,877,717,3150110140,062014,B542
1178,CAMPOLIETO,CB,800,408,392,3140190090,070009,B544
1179,CAMPOLONGO MAGGIORE,VE,10725,5336,5389,1050870030,027003,B546
1180,CAMPOLONGO TAPOGLIANO,UD,1132,557,575,1060850175,030138,M311
1181,CAMPOMAGGIORE,PZ,730,356,374,3170640170,076017,B549
1182,CAMPOMARINO,CB,7648,3958,3690,3140190100,070010,B550
1183,CAMPOMORONE,GE,6482,3149,3333,1070340090,010009,B551
1184,CAMPONOGARA,VE,13005,6389,6616,1050870040,027004,B554
1185,CAMPORA,SA,325,169,156,3150720230,065023,B555
1186,CAMPOREALE,PA,3015,1488,1527,4190550171,082019,B556
1187,CAMPORGIANO,LU,2041,1020,1021,2090430060,046006,B557
1188,CAMPOROSSO,IM,5577,2755,2822,1070370100,008011,B559
1189,CAMPOROTONDO DI FIASTRONE,MC,501,234,267,2110440080,043008,B562
1190,CAMPOROTONDO ETNEO,CT,5213,2644,2569,4190210120,087012,B561
1191,CAMPOSAMPIERO,PD,11867,5904,5963,1050540190,028019,B563
1192,CAMPOSANO,,5102,2457,2645,3150510130,063013,B565
1193,CAMPOSANTO,MO,3261,1643,1618,1080500040,036004,B566
1194,CAMPOSPINOSO ALBAREDO,PV,1316,649,667,1030570240,018026,B567
1195,CAMPOTOSTO,AQ,473,245,228,3130380160,066016,B569
1196,CAMUGNANO,BO,1804,905,899,1080130100,037010,B572
1197,CANAL SAN BOVO,TN,1472,710,762,1040830350,022038,B577
1198,CANALE,CN,5514,2718,2796,1010270370,004037,B573
1199,CANALE D'AGORDO,BL,1069,527,542,1050100081,025023,B574
1200,CANALE MONTERANO,RM,4156,2031,2125,2120700160,058016,B576
1201,CANARO,RO,2599,1280,1319,1050710090,029009,B578
1202,CANAZEI,TN,1878,895,983,1040830360,022039,B579
1203,CANCELLARA,PZ,1167,572,595,3170640180,076018,B580
1204,CANCELLO ED ARNONE,CE,5511,2794,2717,3150200120,061012,B581
1205,CANDA,RO,855,422,433,1050710100,029010,B582
1206,CANDELA,FG,2540,1277,1263,3160310090,071009,B584
1207,CANDELO,BI,7271,3482,3789,1010960120,096012,B586
1208,CANDIA CANAVESE,TO,1209,592,617,1010810500,001050,B588
1209,CANDIA LOMELLINA,PV,1445,729,716,1030570250,018027,B587
1210,CANDIANA,PD,2214,1127,1087,1050540210,028021,B589
1211,CANDIDA,AV,1104,571,533,3150080160,064016,B590
1212,CANDIDONI,RC,418,211,207,3180670190,080019,B591
1213,CANDIOLO,TO,5610,2786,2824,1010810510,001051,B592
1214,CANEGRATE,MI,12499,6112,6387,1030490460,015046,B593
1215,CANELLI,AT,10181,5002,5179,1010070170,005017,B594
1216,CANEPINA,VT,2913,1445,1468,2120910100,056011,B597
1217,CANEVA,PN,6254,3067,3187,1060930090,093009,B598
1218,CANICATTI',AG,34588,16744,17844,4190010110,084011,B602
1219,CANICATTINI BAGNI,SR,6619,3170,3449,4190760050,089005,B603
1220,CANINO,VT,5089,2564,2525,2120910110,056012,B604
1221,CANISCHIO,TO,286,149,137,1010810520,001052,B605
1222,CANISTRO,AQ,911,439,472,3130380170,066017,B606
1223,CANNA,CS,649,313,336,3180250240,078024,B607
1224,CANNALONGA,SA,981,496,485,3150720240,065024,B608
1225,CANNARA,PG,4198,2057,2141,2100580060,054006,B609
1226,CANNERO RIVIERA,VB,910,451,459,1011020160,103016,B610
1227,CANNETO PAVESE,PV,1306,645,661,1030570270,018029,B613
1228,CANNETO SULL'OGLIO,MN,4237,2140,2097,1030450080,020008,B612
1229,CANNOBIO,VB,5000,2419,2581,1011020170,103017,B615
1230,CANNOLE,LE,1631,811,820,3160410110,075012,B616
1231,CANOLO,RC,703,350,353,3180670200,080020,B617
1232,CANONICA D'ADDA,BG,4235,2180,2055,1030120470,016049,B618
1233,CANOSA DI PUGLIA,BT,28187,13933,14254,3161060040,110004,B619
1234,CANOSA SANNITA,CH,1288,629,659,3130230100,069010,B620
1235,CANOSIO,CN,79,43,36,1010270380,004038,B621
1236,CANOSSA,RE,3708,1891,1817,1080680180,035018,C669
1237,CANSANO,AQ,205,93,112,3130380180,066018,B624
1238,CANTAGALLO,PO,3092,1612,1480,2091000010,100001,B626
1239,CANTALICE,RI,2457,1212,1245,2120690080,057009,B627
1240,CANTALUPA,TO,2602,1291,1311,1010810521,001053,B628
1241,CANTALUPO IN SABINA,RI,1642,813,829,2120690090,057010,B631
1242,CANTALUPO LIGURE,AL,454,222,232,1010020280,006028,B629
1243,CANTALUPO NEL SANNIO,IS,725,390,335,3140940050,094005,B630
1244,CANTARANA,AT,987,496,491,1010070180,005018,B633
1245,CANTELLO,VA,4726,2317,2409,1030860230,012030,B634
1246,CANTERANO,RM,356,190,166,2120700170,058017,B635
1247,CANTIANO,PU,2026,1000,1026,2110590080,041008,B636
1248,CANTOIRA,TO,596,316,280,1010810530,001054,B637
1249,CANTU',CO,39382,19320,20062,1030240400,013041,B639
1250,CANZANO,TE,1794,893,901,3130790080,067009,B640
1251,CANZO,CO,5111,2484,2627,1030240410,013042,B641
1252,CAORLE,VE,11155,5397,5758,1050870050,027005,B642
1253,CAORSO,PC,4701,2348,2353,1080610100,033010,B643
1254,CAPACCIO PAESTUM,SA,22331,11270,11061,3150720250,065025,B644
1255,CAPACI,PA,11333,5604,5729,4190550180,082020,B645
1256,CAPALBIO,GR,3887,1879,2008,2090360021,053003,B646
1257,CAPANNOLI,PI,6430,3160,3270,2090620060,050005,B647
1258,CAPANNORI,LU,46390,22908,23482,2090430070,046007,B648
1259,CAPENA,RM,10733,5464,5269,2120700180,058018,B649
1260,CAPERGNANICA,CR,2148,1090,1058,1030260110,019012,B650
1261,CAPESTRANO,AQ,840,406,434,3130380190,066019,B651
1262,CAPIAGO INTIMIANO,CO,5474,2676,2798,1030240420,013043,B653
1263,CAPISTRANO,VV,980,475,505,3181030050,102005,B655
1264,CAPISTRELLO,AQ,4875,2385,2490,3130380200,066020,B656
1265,CAPITIGNANO,AQ,619,303,316,3130380210,066021,B658
1266,CAPIZZI,ME,2888,1401,1487,4190480080,083008,B660
1267,CAPIZZONE,BG,1206,596,610,1030120480,016050,B661
1268,CAPO D'ORLANDO,ME,13102,6182,6920,4190480090,083009,B666
1269,CAPO DI PONTE,BS,2327,1118,1209,1030150310,017035,B664
1270,CAPODIMONTE,VT,1655,816,839,2120910120,056013,B663
1271,CAPODRISE,CE,10065,4954,5111,3150200130,061013,B667
1272,CAPOLIVERI,LI,3878,1934,1944,2090420040,049004,B669
1273,CAPOLONA,AR,5244,2538,2706,2090050060,051006,B670
1274,CAPONAGO,MB,5123,2552,2571,1031040145,108052,B671
1275,CAPORCIANO,AQ,206,110,96,3130380220,066022,B672
1276,CAPOSELE,AV,3271,1605,1666,3150080170,064017,B674
1277,CAPOTERRA,CA,23235,11544,11691,4200170110,092011,B675
1278,CAPOVALLE,BS,345,170,175,1030150320,017036,B676
1279,CAPPADOCIA,AQ,563,319,244,3130380230,066023,B677
1280,CAPPELLA CANTONE,CR,543,263,280,1030260120,019013,B679
1281,CAPPELLA DE' PICENARDI,CR,416,208,208,1030260130,019014,B680
1282,CAPPELLA MAGGIORE,TV,4657,2301,2356,1050840070,026007,B678
1283,CAPPELLE SUL TAVO,PE,4017,1985,2032,3130600060,068006,B681
1284,CAPRACOTTA,IS,815,422,393,3140940060,094006,B682
1285,CAPRAIA E LIMITE,FI,7881,3908,3973,2090300080,048008,B684
1286,CAPRAIA ISOLA,LI,378,215,163,2090420050,049005,B685
1287,CAPRALBA,CR,2267,1138,1129,1030260140,019015,B686
1288,CAPRANICA,VT,6377,3118,3259,2120910130,056014,B688
1289,CAPRANICA PRENESTINA,RM,309,163,146,2120700190,058019,B687
1290,CAPRARICA DI LECCE,LE,2322,1111,1211,3160410120,075013,B690
1291,CAPRAROLA,VT,5218,2584,2634,2120910140,056015,B691
1292,CAPRAUNA,CN,96,54,42,1010270390,004039,B692
1293,CAPRESE MICHELANGELO,AR,1355,658,697,2090050070,051007,B693
1294,CAPREZZO,VB,171,92,79,1011020180,103018,B694
1295,CAPRI,,6827,3358,3469,3150510140,063014,B696
1296,CAPRI LEONE,ME,4354,2096,2258,4190480100,083010,B695
1297,CAPRIANA,TN,588,301,287,1040830370,022040,B697
1298,CAPRIANO DEL COLLE,BS,4633,2374,2259,1030150330,017037,B698
1299,CAPRIATA D'ORBA,AL,1777,888,889,1010020290,006029,B701
1300,CAPRIATE SAN GERVASIO,BG,8190,4126,4064,1030120490,016051,B703
1301,CAPRIATI A VOLTURNO,CE,1469,696,773,3150200140,061014,B704
1302,CAPRIE,TO,2060,1042,1018,1010810540,001055,B705
1303,CAPRIGLIA IRPINA,AV,2263,1125,1138,3150080180,064018,B706
1304,CAPRIGLIO,AT,306,168,138,1010070190,005019,B707
1305,CAPRILE,BI,196,104,92,1010960130,096013,B708
1306,CAPRINO BERGAMASCO,BG,3039,1573,1466,1030120500,016052,B710
1307,CAPRINO VERONESE,VR,8604,4211,4393,1050890180,023018,B709
1308,CAPRIOLO,BS,9431,4717,4714,1030150340,017038,B711
1309,CAPRIVA DEL FRIULI,GO,1617,775,842,1060350010,031001,B712
1310,CAPUA,CE,17645,8582,9063,3150200150,061015,B715
1311,CAPURSO,BA,15275,7434,7841,3160090140,072014,B716
1312,CARAFFA DEL BIANCO,RC,463,212,251,3180670210,080021,B718
1313,CARAFFA DI CATANZARO,CZ,1739,868,871,3180220160,079017,B717
1314,CARAGLIO,CN,6755,3381,3374,1010270400,004040,B719
1315,CARAMAGNA PIEMONTE,CN,3072,1529,1543,1010270410,004041,B720
1316,CARAMANICO TERME,PE,1796,897,899,3130600070,068007,B722
1317,CARAPELLE,FG,6782,3382,3400,3160310091,071010,B724
1318,CARAPELLE CALVISIO,AQ,78,41,37,3130380240,066024,B725
1319,CARASCO,GE,3770,1841,1929,1070340100,010010,B726
1320,CARASSAI,AP,981,482,499,2110060100,044010,B727
1321,CARATE BRIANZA,MB,17788,8723,9065,1031040150,108015,B729
1322,CARATE URIO,CO,1101,535,566,1030240430,013044,B730
1323,CARAVAGGIO,BG,16109,7947,8162,1030120510,016053,B731
1324,CARAVATE,VA,2551,1285,1266,1030860240,012031,B732
1325,CARAVINO,TO,901,450,451,1010810550,001056,B733
1326,CARAVONICA,IM,262,143,119,1070370110,008012,B734
1327,CARBOGNANO,VT,1934,928,1006,2120910150,056016,B735
1328,CARBONARA AL TICINO,PV,1428,720,708,1030570280,018030,B741
1329,CARBONARA DI NOLA,,2482,1246,1236,3150510150,063015,B740
1330,CARBONARA SCRIVIA,AL,1104,547,557,1010020300,006030,B736
1331,CARBONATE,CO,2896,1456,1440,1030240431,013045,B742
1332,CARBONE,PZ,541,266,275,3170640190,076019,B743
1333,CARBONERA,TV,11277,5533,5744,1050840080,026008,B744
1334,CARBONIA,SU,26565,12720,13845,4201110090,111009,B745
1335,CARCARE,SV,5254,2482,2772,1070740180,009018,B748
1336,CARCOFORO,VC,72,37,35,1010880290,002029,B752
1337,CARDANO AL CAMPO,VA,14728,7243,7485,1030860250,012032,B754
1338,CARDE',CN,1143,560,583,1010270420,004042,B755
1339,CARDEDU,NU,1927,946,981,4200530132,091103,M285
1340,CARDETO,RC,1361,645,716,3180670220,080022,B756
1341,CARDINALE,CZ,1856,891,965,3180220170,079018,B758
1342,CARDITO,,21599,10636,10963,3150510160,063016,B759
1343,CAREGGINE,LU,509,256,253,2090430080,046008,B760
1344,CAREMA,TO,739,347,392,1010810560,001057,B762
1345,CARENNO,LC,1382,681,701,1030980140,097014,B763
1346,CARENTINO,AL,321,165,156,1010020301,006031,B765
1347,CARERI,RC,2135,1052,1083,3180670230,080023,B766
1348,CARESANA,VC,1057,585,472,1010880300,002030,B767
1349,CARESANABLOT,VC,1088,531,557,1010880310,002031,B768
1350,CAREZZANO,AL,426,210,216,1010020310,006032,B769
1351,CARFIZZI,KR,524,246,278,3180970030,101003,B771
1352,CARGEGHE,SS,593,303,290,4200730220,090022,B772
1353,CARIATI,CS,7476,3638,3838,3180250250,078025,B774
1354,CARIFE,AV,1289,630,659,3150080190,064019,B776
1355,CARIGNANO,TO,9052,4437,4615,1010810570,001058,B777
1356,CARIMATE,CO,4429,2209,2220,1030240440,013046,B778
1357,CARINARO,CE,7121,3483,3638,3150200160,061016,B779
1358,CARINI,PA,39275,19563,19712,4190550190,082021,B780
1359,CARINOLA,CE,7216,3650,3566,3150200170,061017,B781
1360,CARISIO,VC,772,396,376,1010880320,002032,B782
1361,CARISOLO,TN,948,466,482,1040830390,022042,B783
1362,CARLANTINO,FG,826,398,428,3160310100,071011,B784
1363,CARLAZZO,CO,3144,1505,1639,1030240450,013047,B785
1364,CARLENTINI,SR,17160,8335,8825,4190760060,089006,B787
1365,CARLINO,UD,2702,1313,1389,1060850180,030018,B788
1366,CARLOFORTE,SU,5983,2977,3006,4201110100,111010,B789
1367,CARLOPOLI,CZ,1406,705,701,3180220190,079020,B790
1368,CARMAGNOLA,TO,28313,13858,14455,1010810580,001059,B791
1369,CARMIANO,LE,11720,5746,5974,3160410130,075014,B792
1370,CARMIGNANO,PO,14753,7335,7418,2091000020,100002,B794
1371,CARMIGNANO DI BRENTA,PD,7478,3769,3709,1050540230,028023,B795
1372,CARNAGO,VA,6600,3256,3344,1030860260,012033,B796
1373,CARNATE,MB,7594,3806,3788,1031040160,108016,B798
1374,CAROBBIO DEGLI ANGELI,BG,4811,2440,2371,1030120530,016055,B801
1375,CAROLEI,CS,3155,1594,1561,3180250260,078026,B802
1376,CARONA,BG,286,131,155,1030120540,016056,B803
1377,CARONIA,ME,3093,1481,1612,4190480110,083011,B804
1378,CARONNO PERTUSELLA,VA,18116,8956,9160,1030860270,012034,B805
1379,CARONNO VARESINO,VA,4786,2377,2409,1030860280,012035,B807
1380,CAROSINO,TA,6663,3248,3415,3160780020,073002,B808
1381,CAROVIGNO,BR,16925,8473,8452,3160160020,074002,B809
1382,CAROVILLI,IS,1273,646,627,3140940070,094007,B810
1383,CARPANETO PIACENTINO,PC,7649,3782,3867,1080610110,033011,B812
1384,CARPANZANO,CS,210,100,110,3180250270,078027,B813
1385,CARPEGNA,PU,1634,807,827,2110590090,041009,B816
1386,CARPENEDOLO,BS,12977,6527,6450,1030150350,017039,B817
1387,CARPENETO,AL,911,462,449,1010020320,006033,B818
1388,CARPI,MO,71402,34848,36554,1080500050,036005,B819
1389,CARPIANO,MI,4150,2129,2021,1030490500,015050,B820
1390,CARPIGNANO SALENTINO,LE,3678,1833,1845,3160410140,075015,B822
1391,CARPIGNANO SESIA,NO,2470,1151,1319,1010520350,003036,B823
1392,CARPINETI,RE,3884,1919,1965,1080680110,035011,B825
1393,CARPINETO DELLA NORA,PE,556,275,281,3130600080,068008,B827
1394,CARPINETO ROMANO,RM,4094,1987,2107,2120700200,058020,B828
1395,CARPINETO SINELLO,CH,530,269,261,3130230110,069011,B826
1396,CARPINO,FG,3881,1932,1949,3160310110,071012,B829
1397,CARPINONE,IS,1042,503,539,3140940080,094008,B830
1398,CARRARA,MS,60185,29114,31071,2090460030,045003,B832
1399,CARRE',VI,3500,1731,1769,1050900240,024024,B835
1400,CARREGA LIGURE,AL,88,52,36,1010020330,006034,B836
1401,CARRO,SP,514,245,269,1070390090,011009,B838
1402,CARRODANO,SP,477,247,230,1070390100,011010,B839
1403,CARROSIO,AL,494,261,233,1010020340,006035,B840
1404,CARRU',CN,4382,2182,2200,1010270430,004043,B841
1405,CARSOLI,AQ,5067,2505,2562,3130380250,066025,B842
1406,CARTIGLIANO,VI,3711,1832,1879,1050900250,024025,B844
1407,CARTIGNANO,CN,175,83,92,1010270440,004044,B845
1408,CARTOCETO,PU,7966,3938,4028,2110590100,041010,B846
1409,CARTOSIO,AL,720,349,371,1010020350,006036,B847
1410,CARTURA,PD,4582,2258,2324,1050540260,028026,B848
1411,CARUGATE,MI,15664,7774,7890,1030490510,015051,B850
1412,CARUGO,CO,6569,3278,3291,1030240460,013048,B851
1413,CARUNCHIO,CH,579,322,257,3130230120,069012,B853
1414,CARVICO,BG,4646,2284,2362,1030120550,016057,B854
1415,CARZANO,TN,518,259,259,1040830400,022043,B856
1416,CASABONA,KR,2377,1128,1249,3180970040,101004,B857
1417,CASACALENDA,CB,1880,946,934,3140190110,070011,B858
1418,CASACANDITELLA,CH,1170,598,572,3130230130,069013,B859
1419,CASAGIOVE,CE,13116,6319,6797,3150200180,061018,B860
1420,CASAL CERMELLI,AL,1182,575,607,1010020360,006037,B870
1421,CASAL DI PRINCIPE,CE,21244,10628,10616,3150200190,061019,B872
1422,CASAL VELINO,SA,5343,2681,2662,3150720280,065028,B895
1423,CASALANGUIDA,CH,837,395,442,3130230140,069014,B861
1424,CASALATTICO,FR,544,267,277,2120330170,060017,B862
1425,CASALBELTRAME,NO,991,499,492,1010520360,003037,B864
1426,CASALBORDINO,CH,5830,2780,3050,3130230150,069015,B865
1427,CASALBORE,AV,1608,780,828,3150080200,064020,B866
1428,CASALBORGONE,TO,1855,906,949,1010810590,001060,B867
1429,CASALBUONO,SA,1065,528,537,3150720260,065026,B868
1430,CASALBUTTANO ED UNITI,CR,3652,1777,1875,1030260150,019016,B869
1431,CASALCIPRANO,CB,470,229,241,3140190120,070012,B871
1432,CASALDUNI,BN,1238,620,618,3150110150,062015,B873
1433,CASALE CORTE CERRO,VB,3385,1670,1715,1011020190,103019,B876
1434,CASALE CREMASCO-VIDOLASCO,CR,1829,946,883,1030260160,019017,B881
1435,CASALE DI SCODOSIA,PD,4701,2359,2342,1050540270,028027,B877
1436,CASALE LITTA,VA,2729,1359,1370,1030860290,012036,B875
1437,CASALE MARITTIMO,PI,1076,544,532,2090620070,050006,B878
1438,CASALE MONFERRATO,AL,32399,15392,17007,1010020380,006039,B885
1439,CASALE SUL SILE,TV,13160,6488,6672,1050840090,026009,B879
1440,CASALECCHIO DI RENO,BO,35784,16930,18854,1080130110,037011,B880
1441,CASALEGGIO BOIRO,AL,370,186,184,1010020370,006038,B882
1442,CASALEGGIO NOVARA,NO,905,446,459,1010520380,003039,B883
1443,CASALEONE,VR,5551,2771,2780,1050890190,023019,B886
1444,CASALETTO CEREDANO,CR,1151,582,569,1030260170,019018,B889
1445,CASALETTO DI SOPRA,CR,515,271,244,1030260180,019019,B890
1446,CASALETTO LODIGIANO,LO,2959,1489,1470,1030990080,098008,B887
1447,CASALETTO SPARTANO,SA,1303,627,676,3150720270,065027,B888
1448,CASALETTO VAPRIO,CR,1771,855,916,1030260190,019020,B891
1449,CASALFIUMANESE,BO,3367,1695,1672,1080130120,037012,B892
1450,CASALGRANDE,RE,18857,9436,9421,1080680120,035012,B893
1451,CASALGRASSO,CN,1412,717,695,1010270450,004045,B894
1452,CASALI DEL MANCO,CS,9596,4753,4843,3180250275,078156,M385
1453,CASALINCONTRADA,CH,3011,1489,1522,3130230160,069016,B896
1454,CASALINO,NO,1523,776,747,1010520390,003040,B897
1455,CASALMAGGIORE,CR,14974,7508,7466,1030260200,019021,B898
1456,CASALMAIOCCO,LO,3208,1572,1636,1030990090,098009,B899
1457,CASALMORANO,CR,1621,794,827,1030260210,019022,B900
1458,CASALMORO,MN,2208,1122,1086,1030450100,020010,B901
1459,CASALNOCETO,AL,969,490,479,1010020390,006040,B902
1460,CASALNUOVO DI NAPOLI,,47428,23135,24293,3150510170,063017,B905
1461,CASALNUOVO MONTEROTARO,FG,1379,686,693,3160310120,071013,B904
1462,CASALOLDO,MN,2654,1319,1335,1030450110,020011,B907
1463,CASALPUSTERLENGO,LO,15399,7650,7749,1030990100,098010,B910
1464,CASALROMANO,MN,1483,735,748,1030450120,020012,B911
1465,CASALSERUGO,PD,5390,2657,2733,1050540280,028028,B912
1466,CASALUCE,CE,9543,4697,4846,3150200200,061020,B916
1467,CASALVECCHIO DI PUGLIA,FG,1704,841,863,3160310130,071014,B917
1468,CASALVECCHIO SICULO,ME,735,391,344,4190480120,083012,B918
1469,CASALVIERI,FR,2438,1211,1227,2120330180,060018,B919
1470,CASALVOLONE,NO,875,444,431,1010520400,003041,B920
1471,CASALZUIGNO,VA,1362,671,691,1030860300,012037,B921
1472,CASAMARCIANO,,3048,1499,1549,3150510180,063018,B922
1473,CASAMASSIMA,BA,19404,9571,9833,3160090150,072015,B923
1474,CASAMICCIOLA TERME,,7715,3775,3940,3150510190,063019,B924
1475,CASANDRINO,,13363,6944,6419,3150510200,063020,B925
1476,CASANOVA ELVO,VC,222,122,100,1010880330,002033,B928
1477,CASANOVA LERRONE,SV,737,365,372,1070740190,009019,B927
1478,CASANOVA LONATI,PV,453,239,214,1030570290,018031,B929
1479,CASAPE,RM,643,316,327,2120700210,058021,B932
1480,CASAPESENNA,CE,6869,3362,3507,3150200201,061103,M260
1481,CASAPINTA,BI,397,178,219,1010960140,096014,B933
1482,CASAPROTA,RI,691,340,351,2120690100,057011,B934
1483,CASAPULLA,CE,8374,4091,4283,3150200210,061021,B935
1484,CASARANO,LE,19372,9203,10169,3160410150,075016,B936
1485,CASARGO,LC,837,413,424,1030980150,097015,B937
1486,CASARILE,MI,4020,1983,2037,1030490550,015055,B938
1487,CASARSA DELLA DELIZIA,PN,8240,4125,4115,1060930100,093010,B940
1488,CASARZA LIGURE,GE,6729,3331,3398,1070340110,010011,B939
1489,CASASCO,AL,121,62,59,1010020400,006041,B941
1490,CASATENOVO,LC,13183,6463,6720,1030980160,097016,B943
1491,CASATISMA,PV,866,432,434,1030570300,018032,B945
1492,CASAVATORE,,18282,8872,9410,3150510210,063021,B946
1493,CASAZZA,BG,3838,1900,1938,1030120560,016058,B947
1494,CASCIA,PG,2979,1477,1502,2100580070,054007,B948
1495,CASCIAGO,VA,3617,1758,1859,1030860310,012038,B949
1496,CASCIANA TERME LARI,PI,12160,6009,6151,2090620075,050040,M327
1497,CASCINA,PI,44865,21758,23107,2090620080,050008,B950
1498,CASCINETTE D'IVREA,TO,1524,744,780,1010810600,001061,B953
1499,CASEI GEROLA,PV,2379,1187,1192,1030570310,018033,B954
1500,CASELETTE,TO,3034,1507,1527,1010810610,001062,B955
1501,CASELLA,GE,3125,1589,1536,1070340120,010012,B956
1502,CASELLE IN PITTARI,SA,1864,917,947,3150720290,065029,B959
1503,CASELLE LANDI,LO,1497,760,737,1030990110,098011,B961
1504,CASELLE LURANI,LO,3038,1563,1475,1030990120,098012,B958
1505,CASELLE TORINESE,TO,13834,6839,6995,1010810620,001063,B960
1506,CASERTA,CE,73037,34445,38592,3150200220,061022,B963
1507,CASIER,TV,11356,5594,5762,1050840100,026010,B965
1508,CASIGNANA,RC,707,340,367,3180670240,080024,B966
1509,CASINA,RE,4510,2251,2259,1080680130,035013,B967
1510,CASIRATE D'ADDA,BG,4069,2043,2026,1030120570,016059,B971
1511,CASLINO D'ERBA,CO,1644,803,841,1030240500,013052,B974
1512,CASNATE CON BERNATE,CO,5011,2462,2549,1030240510,013053,B977
1513,CASNIGO,BG,3075,1554,1521,1030120580,016060,B978
1514,CASOLA DI NAPOLI,,3663,1782,1881,3150510220,063022,B980
1515,CASOLA IN LUNIGIANA,MS,969,468,501,2090460040,045004,B979
1516,CASOLA VALSENIO,RA,2541,1334,1207,1080660050,039005,B982
1517,CASOLE D'ELSA,SI,3716,1849,1867,2090750040,052004,B984
1518,CASOLI,CH,5230,2557,2673,3130230170,069017,B985
1519,CASORATE PRIMO,PV,8766,4396,4370,1030570320,018034,B988
1520,CASORATE SEMPIONE,VA,5671,2751,2920,1030860320,012039,B987
1521,CASOREZZO,MI,5535,2719,2816,1030490580,015058,B989
1522,CASORIA,,74394,36115,38279,3150510230,063023,B990
1523,CASORZO MONFERRATO,AT,610,291,319,1010070200,005020,B991
1524,CASPERIA,RI,1199,577,622,2120690110,057012,A472
1525,CASPOGGIO,SO,1342,662,680,1030770130,014013,B993
1526,CASSACCO,UD,2807,1389,1418,1060850190,030019,B994
1527,CASSAGO BRIANZA,LC,4370,2191,2179,1030980170,097017,B996
1528,CASSANO ALL'IONIO,CS,16579,8297,8282,3180250290,078029,C002
1529,CASSANO D'ADDA,MI,19194,9411,9783,1030490590,015059,C003
1530,CASSANO DELLE MURGE,BA,14970,7443,7527,3160090160,072016,B998
1531,CASSANO IRPINO,AV,930,470,460,3150080210,064021,B997
1532,CASSANO MAGNAGO,VA,21362,10479,10883,1030860330,012040,C004
1533,CASSANO SPINOLA,AL,1825,881,944,1010020411,006191,M388
1534,CASSANO VALCUVIA,VA,670,327,343,1030860340,012041,B999
1535,CASSARO,SR,725,360,365,4190760070,089007,C006
1536,CASSIGLIO,BG,111,52,59,1030120590,016061,C007
1537,CASSINA DE' PECCHI,MI,13941,6779,7162,1030490600,015060,C014
1538,CASSINA RIZZARDI,CO,3294,1604,1690,1030240530,013055,C020
1539,CASSINA VALSASSINA,LC,529,271,258,1030980180,097018,C024
1540,CASSINASCO,AT,542,273,269,1010070210,005021,C022
1541,CASSINE,AL,2821,1424,1397,1010020420,006043,C027
1542,CASSINELLE,AL,852,444,408,1010020430,006044,C030
1543,CASSINETTA DI LUGAGNANO,MI,1906,930,976,1030490610,015061,C033
1544,CASSINO,FR,35235,17405,17830,2120330190,060019,C034
1545,CASSOLA,VI,15090,7408,7682,1050900260,024026,C037
1546,CASSOLNOVO,PV,6762,3334,3428,1030570330,018035,C038
1547,CASTAGNARO,VR,3587,1777,1810,1050890200,023020,C041
1548,CASTAGNETO CARDUCCI,LI,8785,4327,4458,2090420060,049006,C044
1549,CASTAGNETO PO,TO,1763,897,866,1010810630,001064,C045
1550,CASTAGNITO,CN,2184,1079,1105,1010270460,004046,C046
1551,CASTAGNOLE DELLE LANZE,AT,3648,1777,1871,1010070220,005022,C049
1552,CASTAGNOLE MONFERRATO,AT,1152,586,566,1010070230,005023,C047
1553,CASTAGNOLE PIEMONTE,TO,2179,1090,1089,1010810640,001065,C048
1554,CASTANA,PV,710,345,365,1030570340,018036,C050
1555,CASTANO PRIMO,MI,10862,5427,5435,1030490620,015062,C052
1556,CASTEGGIO,PV,6490,3094,3396,1030570350,018037,C053
1557,CASTEGNATO,BS,8327,4170,4157,1030150360,017040,C055
1558,CASTEGNERO,VI,2849,1438,1411,1050900270,024027,C056
1559,CASTEL BARONIA,AV,1069,530,539,3150080220,064022,C058
1560,CASTEL BOGLIONE,AT,572,311,261,1010070240,005024,C064
1561,CASTEL BOLOGNESE,RA,9535,4738,4797,1080660060,039006,C065
1562,CASTEL CAMPAGNANO,CE,1473,702,771,3150200230,061023,B494
1563,CASTEL CASTAGNA,TE,451,228,223,3130790090,067010,C040
1564,CASTEL CONDINO,TN,224,111,113,1040830430,022045,C183
1565,CASTEL D'AIANO,BO,1886,972,914,1080130130,037013,C075
1566,CASTEL D'ARIO,MN,4594,2249,2345,1030450140,020014,C076
1567,CASTEL D'AZZANO,VR,12053,5955,6098,1050890210,023021,C078
1568,CASTEL DEL GIUDICE,IS,322,169,153,3140940090,094009,C082
1569,CASTEL DEL MONTE,AQ,456,254,202,3130380260,066026,C083
1570,CASTEL DEL PIANO,GR,4808,2407,2401,2090360030,053004,C085
1571,CASTEL DEL RIO,BO,1186,577,609,1080130140,037014,C086
1572,CASTEL DI CASIO,BO,3309,1644,1665,1080130150,037015,B969
1573,CASTEL DI IERI,AQ,296,142,154,3130380270,066027,C090
1574,CASTEL DI IUDICA,CT,4309,2098,2211,4190210130,087013,C091
1575,CASTEL DI LAMA,AP,8414,4174,4240,2110060110,044011,C093
1576,CASTEL DI LUCIO,ME,1184,579,605,4190480130,083013,C094
1577,CASTEL DI SANGRO,AQ,6543,3351,3192,3130380280,066028,C096
1578,CASTEL DI SASSO,CE,1076,527,549,3150200240,061024,C097
1579,CASTEL DI TORA,RI,268,139,129,2120690120,057013,C098
1580,CASTEL FOCOGNANO,AR,2963,1484,1479,2090050080,051008,C102
1581,CASTEL FRENTANO,CH,4262,2051,2211,3130230180,069018,C114
1582,CASTEL GABBIANO,CR,458,244,214,1030260230,019024,C115
1583,CASTEL GANDOLFO,RM,8652,4111,4541,2120700220,058022,C116
1584,CASTEL GIORGIO,TR,2034,959,1075,2100800090,055009,C117
1585,CASTEL GOFFREDO,MN,12548,6280,6268,1030450150,020015,C118
1586,CASTEL GUELFO DI BOLOGNA,BO,4516,2262,2254,1080130160,037016,C121
1587,CASTEL IVANO,TN,3260,1620,1640,1040830435,022240,M354
1588,CASTEL MADAMA,RM,7107,3545,3562,2120700230,058023,C203
1589,CASTEL MAGGIORE,BO,18500,8930,9570,1080130190,037019,C204
1590,CASTEL MELLA,BS,10993,5533,5460,1030150380,017042,C208
1591,CASTEL MORRONE,CE,3627,1750,1877,3150200260,061026,C211
1592,CASTEL RITALDI,PG,3048,1507,1541,2100580080,054008,C252
1593,CASTEL ROCCHERO,AT,389,196,193,1010070320,005032,C253
1594,CASTEL ROZZONE,BG,2773,1365,1408,1030120610,016063,C255
1595,CASTEL SAN GIORGIO,SA,13655,6780,6875,3150720340,065034,C259
1596,CASTEL SAN GIOVANNI,PC,13981,6937,7044,1080610130,033013,C261
1597,CASTEL SAN LORENZO,SA,2246,1085,1161,3150720350,065035,C262
1598,CASTEL SAN NICCOLO',AR,2517,1235,1282,2090050100,051010,C263
1599,CASTEL SAN PIETRO ROMANO,RM,841,402,439,2120700250,058025,C266
1600,CASTEL SAN PIETRO TERME,BO,20666,10121,10545,1080130200,037020,C265
1601,CASTEL SAN VINCENZO,IS,461,233,228,3140940120,094012,C270
1602,CASTEL SANT'ANGELO,RI,1195,603,592,2120690140,057015,C268
1603,CASTEL SANT'ELIA,VT,2471,1221,1250,2120910160,056017,C269
1604,CASTEL VISCARDO,TR,2731,1334,1397,2100800100,055010,C289
1605,CASTEL VITTORIO,IM,261,139,122,1070370140,008015,C110
1606,CASTEL VOLTURNO,CE,27804,14447,13357,3150200270,061027,C291
1607,CASTELBALDO,PD,1430,714,716,1050540290,028029,C057
1608,CASTELBELFORTE,MN,3231,1616,1615,1030450130,020013,C059
1609,CASTELBELLINO,AN,4928,2365,2563,2110030080,042008,C060
1610,CASTELBELLO-CIARDES/KASTELBELL-TSCHARS,BZ,2309,1181,1128,1040140150,021018,C062
1611,CASTELBIANCO,SV,316,154,162,1070740200,009020,C063
1612,CASTELBOTTACCIO,CB,251,122,129,3140190130,070013,C066
1613,CASTELBUONO,PA,8219,4013,4206,4190550200,082022,C067
1614,CASTELCIVITA,SA,1470,751,719,3150720300,065030,C069
1615,CASTELCOVATI,BS,6785,3446,3339,1030150370,017041,C072
1616,CASTELCUCCO,TV,2299,1153,1146,1050840110,026011,C073
1617,CASTELDACCIA,PA,11643,5755,5888,4190550210,082023,C074
1618,CASTELDELCI,RN,370,181,189,1081010015,099021,C080
1619,CASTELDELFINO,CN,143,69,74,1010270470,004047,C081
1620,CASTELDIDONE,CR,569,298,271,1030260220,019023,C089
1621,CASTELFIDARDO,AN,18468,9099,9369,2110030100,042010,C100
1622,CASTELFIORENTINO,FI,17364,8504,8860,2090300100,048010,C101
1623,CASTELFORTE,LT,4160,2018,2142,2120400040,059004,C104
1624,CASTELFRANCI,AV,1821,897,924,3150080230,064023,C105
1625,CASTELFRANCO DI SOTTO,PI,13460,6726,6734,2090620090,050009,C113
1626,CASTELFRANCO EMILIA,MO,33061,16701,16360,1080500060,036006,C107
1627,CASTELFRANCO IN MISCANO,BN,819,411,408,3150110160,062016,C106
1628,CASTELFRANCO PIANDISCO',AR,9832,4845,4987,2090050095,051040,M322
1629,CASTELFRANCO VENETO,TV,33056,16110,16946,1050840120,026012,C111
1630,CASTELGERUNDO,LO,1481,751,730,1030990125,098062,M393
1631,CASTELGOMBERTO,VI,6132,3106,3026,1050900280,024028,C119
1632,CASTELGRANDE,PZ,825,422,403,3170640210,076021,C120
1633,CASTELGUGLIELMO,RO,1514,770,744,1050710110,029011,C122
1634,CASTELGUIDONE,CH,304,144,160,3130230190,069019,C123
1635,CASTELL'ALFERO,AT,2637,1303,1334,1010070250,005025,C127
1636,CASTELL'ARQUATO,PC,4577,2250,2327,1080610120,033012,C145
1637,CASTELL'AZZARA,GR,1311,638,673,2090360040,053005,C147
1638,CASTELL'UMBERTO,ME,2878,1392,1486,4190480140,083014,C051
1639,CASTELLABATE,SA,8658,4311,4347,3150720310,065031,C125
1640,CASTELLAFIUME,AQ,1044,535,509,3130380290,066029,C126
1641,CASTELLALTO,TE,7338,3673,3665,3130790100,067011,C128
1642,CASTELLAMMARE DEL GOLFO,TP,14636,7304,7332,4190820060,081005,C130
1643,CASTELLAMMARE DI STABIA,,63330,30312,33018,3150510240,063024,C129
1644,CASTELLAMONTE,TO,9695,4787,4908,1010810650,001066,C133
1645,CASTELLANA GROTTE,BA,19401,9397,10004,3160090170,072017,C134
1646,CASTELLANA SICULA,PA,3089,1471,1618,4190550220,082024,C135
1647,CASTELLANETA,TA,16343,7978,8365,3160780030,073003,C136
1648,CASTELLANIA COPPI,AL,88,48,40,1010020440,006045,C137
1649,CASTELLANZA,VA,14077,6742,7335,1030860350,012042,C139
1650,CASTELLAR GUIDOBONO,AL,398,202,196,1010020450,006046,C142
1651,CASTELLARANO,RE,15319,7655,7664,1080680140,035014,C141
1652,CASTELLARO,IM,1267,620,647,1070370130,008014,C143
1653,CASTELLAZZO BORMIDA,AL,4435,2191,2244,1010020460,006047,C148
1654,CASTELLAZZO NOVARESE,NO,316,159,157,1010520410,003042,C149
1655,CASTELLEONE,CR,9270,4576,4694,1030260240,019025,C153
1656,CASTELLEONE DI SUASA,AN,1568,786,782,2110030110,042011,C152
1657,CASTELLERO,AT,291,136,155,1010070260,005026,C154
1658,CASTELLETTO CERVO,BI,796,404,392,1010960150,096015,C155
1659,CASTELLETTO D'ERRO,AL,135,62,73,1010020470,006048,C156
1660,CASTELLETTO D'ORBA,AL,1855,916,939,1010020480,006049,C158
1661,CASTELLETTO DI BRANDUZZO,PV,989,500,489,1030570360,018038,C157
1662,CASTELLETTO MERLI,AL,452,234,218,1010020490,006050,C160
1663,CASTELLETTO MOLINA,AT,143,66,77,1010070270,005027,C161
1664,CASTELLETTO MONFERRATO,AL,1443,726,717,1010020500,006051,C162
1665,CASTELLETTO SOPRA TICINO,NO,9826,4729,5097,1010520420,003043,C166
1666,CASTELLETTO STURA,CN,1349,681,668,1010270490,004049,C165
1667,CASTELLETTO UZZONE,CN,310,159,151,1010270500,004050,C167
1668,CASTELLI,TE,997,497,500,3130790110,067012,C169
1669,CASTELLI CALEPIO,BG,10398,5225,5173,1030120600,016062,C079
1670,CASTELLINA IN CHIANTI,SI,2677,1387,1290,2090750050,052005,C172
1671,CASTELLINA MARITTIMA,PI,1835,931,904,2090620100,050010,C174
1672,CASTELLINALDO D'ALBA,CN,915,462,453,1010270510,004051,C173
1673,CASTELLINO DEL BIFERNO,CB,444,217,227,3140190140,070014,C175
1674,CASTELLINO TANARO,CN,281,142,139,1010270520,004052,C176
1675,CASTELLIRI,FR,3202,1590,1612,2120330200,060020,C177
1676,CASTELLO CABIAGLIO,VA,558,282,276,1030860360,012043,B312
1677,CASTELLO D'AGOGNA,PV,1072,546,526,1030570370,018039,C184
1678,CASTELLO D'ARGILE,BO,6565,3317,3248,1080130170,037017,C185
1679,CASTELLO DEL MATESE,CE,1410,682,728,3150200250,061025,C178
1680,CASTELLO DELL'ACQUA,SO,615,307,308,1030770140,014014,C186
1681,CASTELLO DI ANNONE,AT,1809,947,862,1010070280,005028,A300
1682,CASTELLO DI BRIANZA,LC,2602,1314,1288,1030980190,097019,C187
1683,CASTELLO DI CISTERNA,,7815,3867,3948,3150510250,063025,C188
1684,CASTELLO DI GODEGO,TV,7112,3525,3587,1050840130,026013,C190
1685,CASTELLO TESINO,TN,1155,588,567,1040830450,022048,C194
1686,CASTELLO-MOLINA DI FIEMME,TN,2319,1164,1155,1040830440,022047,C189
1687,CASTELLUCCHIO,MN,5198,2605,2593,1030450160,020016,C195
1688,CASTELLUCCIO DEI SAURI,FG,2038,1038,1000,3160310140,071015,C198
1689,CASTELLUCCIO INFERIORE,PZ,1947,965,982,3170640220,076022,C199
1690,CASTELLUCCIO SUPERIORE,PZ,731,366,365,3170640230,076023,C201
1691,CASTELLUCCIO VALMAGGIORE,FG,1226,597,629,3160310150,071016,C202
1692,CASTELMAGNO,CN,53,32,21,1010270530,004053,C205
1693,CASTELMARTE,CO,1265,651,614,1030240560,013058,C206
1694,CASTELMASSA,RO,3997,1913,2084,1050710120,029012,C207
1695,CASTELMAURO,CB,1227,589,638,3140190150,070015,C197
1696,CASTELMEZZANO,PZ,727,353,374,3170640240,076024,C209
1697,CASTELMOLA,ME,1062,516,546,4190480150,083015,C210
1698,CASTELNOVETTO,PV,525,256,269,1030570380,018040,C213
1699,CASTELNOVO BARIANO,RO,2639,1300,1339,1050710130,029013,C215
1700,CASTELNOVO DEL FRIULI,PN,831,419,412,1060930110,093011,C217
1701,CASTELNOVO DI SOTTO,RE,8385,4132,4253,1080680150,035015,C218
1702,CASTELNOVO NE' MONTI,RE,10309,5060,5249,1080680160,035016,C219
1703,CASTELNUOVO,TN,1078,528,550,1040830460,022049,C216
1704,CASTELNUOVO BELBO,AT,805,387,418,1010070290,005029,C226
1705,CASTELNUOVO BERARDENGA,SI,8970,4373,4597,2090750060,052006,C227
1706,CASTELNUOVO BOCCA D'ADDA,LO,1542,763,779,1030990130,098013,C228
1707,CASTELNUOVO BORMIDA,AL,612,296,316,1010020510,006052,C229
1708,CASTELNUOVO BOZZENTE,CO,903,440,463,1030240570,013059,C220
1709,CASTELNUOVO CALCEA,AT,692,363,329,1010070300,005030,C230
1710,CASTELNUOVO CILENTO,SA,2802,1340,1462,3150720320,065032,C231
1711,CASTELNUOVO DEL GARDA,VR,13370,6587,6783,1050890220,023022,C225
1712,CASTELNUOVO DELLA DAUNIA,FG,1292,641,651,3160310160,071017,C222
1713,CASTELNUOVO DI CEVA,CN,102,51,51,1010270540,004054,C214
1714,CASTELNUOVO DI CONZA,SA,595,304,291,3150720330,065033,C235
1715,CASTELNUOVO DI FARFA,RI,1020,526,494,2120690130,057014,C224
1716,CASTELNUOVO DI GARFAGNANA,LU,5650,2733,2917,2090430090,046009,C236
1717,CASTELNUOVO DI PORTO,RM,8587,4248,4339,2120700240,058024,C237
1718,CASTELNUOVO DI VAL DI CECINA,PI,2094,1031,1063,2090620110,050011,C244
1719,CASTELNUOVO DON BOSCO,AT,3109,1531,1578,1010070310,005031,C232
1720,CASTELNUOVO MAGRA,SP,8361,4098,4263,1070390110,011011,C240
1721,CASTELNUOVO NIGRA,TO,401,215,186,1010810660,001067,C241
1722,CASTELNUOVO PARANO,FR,858,422,436,2120330210,060021,C223
1723,CASTELNUOVO RANGONE,MO,15040,7535,7505,1080500070,036007,C242
1724,CASTELNUOVO SCRIVIA,AL,4874,2378,2496,1010020520,006053,C243
1725,CASTELPAGANO,BN,1350,680,670,3150110170,062017,C245
1726,CASTELPETROSO,IS,1565,800,765,3140940100,094010,C246
1727,CASTELPIZZUTO,IS,139,77,62,3140940110,094011,C247
1728,CASTELPLANIO,AN,3515,1745,1770,2110030120,042012,C248
1729,CASTELPOTO,BN,1114,543,571,3150110180,062018,C250
1730,CASTELRAIMONDO,MC,4368,2124,2244,2110440090,043009,C251
1731,CASTELROTTO/KASTELRUTH,BZ,6891,3474,3417,1040140160,021019,C254
1732,CASTELSANTANGELO SUL NERA,MC,232,127,105,2110440100,043010,C267
1733,CASTELSARACENO,PZ,1197,577,620,3170640250,076025,C271
1734,CASTELSARDO,SS,5711,2843,2868,4200730230,090023,C272
1735,CASTELSEPRIO,VA,1309,643,666,1030860370,012044,C273
1736,CASTELSILANO,KR,900,446,454,3180970050,101005,B968
1737,CASTELSPINA,AL,392,196,196,1010020521,006054,C274
1738,CASTELTERMINI,AG,7384,3546,3838,4190010120,084012,C275
1739,CASTELVECCANA,VA,1867,925,942,1030860380,012045,C181
1740,CASTELVECCHIO CALVISIO,AQ,124,54,70,3130380300,066030,C278
1741,CASTELVECCHIO DI ROCCA BARBENA,SV,133,72,61,1070740210,009021,C276
1742,CASTELVECCHIO SUBEQUO,AQ,845,398,447,3130380310,066031,C279
1743,CASTELVENERE,BN,2426,1173,1253,3150110190,062019,C280
1744,CASTELVERDE,CR,5549,2777,2772,1030260250,019026,B129
1745,CASTELVERRINO,IS,100,60,40,3140940130,094013,C200
1746,CASTELVETERE IN VAL FORTORE,BN,1027,487,540,3150110200,062020,C284
1747,CASTELVETERE SUL CALORE,AV,1511,758,753,3150080240,064024,C283
1748,CASTELVETRANO,TP,29592,14420,15172,4190820070,081006,C286
1749,CASTELVETRO DI MODENA,MO,11158,5643,5515,1080500080,036008,C287
1750,CASTELVETRO PIACENTINO,PC,5242,2598,2644,1080610140,033014,C288
1751,CASTELVISCONTI,CR,295,147,148,1030260260,019027,C290
1752,CASTENASO,BO,15895,7637,8258,1080130210,037021,C292
1753,CASTENEDOLO,BS,11553,5767,5786,1030150390,017043,C293
1754,CASTIADAS,SU,1661,857,804,4201110110,111011,M288
1755,CASTIGLION FIBOCCHI,AR,2103,1066,1037,2090050110,051011,C318
1756,CASTIGLION FIORENTINO,AR,13052,6455,6597,2090050120,051012,C319
1757,CASTIGLIONE A CASAURIA,PE,734,370,364,3130600090,068009,C308
1758,CASTIGLIONE CHIAVARESE,GE,1580,751,829,1070340130,010013,C302
1759,CASTIGLIONE COSENTINO,CS,2652,1391,1261,3180250300,078030,C301
1760,CASTIGLIONE D'ADDA,LO,4495,2245,2250,1030990140,098014,C304
1761,CASTIGLIONE D'ORCIA,SI,2148,1040,1108,2090750070,052007,C313
1762,CASTIGLIONE DEI PEPOLI,BO,5363,2708,2655,1080130220,037022,C296
1763,CASTIGLIONE DEL GENOVESI,SA,1310,686,624,3150720360,065036,C306
1764,CASTIGLIONE DEL LAGO,PG,15193,7393,7800,2100580090,054009,C309
1765,CASTIGLIONE DELLA PESCAIA,GR,7098,3508,3590,2090360050,053006,C310
1766,CASTIGLIONE DELLE STIVIERE,MN,23313,11610,11703,1030450170,020017,C312
1767,CASTIGLIONE DI GARFAGNANA,LU,1707,860,847,2090430100,046010,C303
1768,CASTIGLIONE DI SICILIA,CT,2930,1440,1490,4190210140,087014,C297
1769,CASTIGLIONE FALLETTO,CN,690,355,335,1010270550,004055,C314
1770,CASTIGLIONE IN TEVERINA,VT,2281,1120,1161,2120910170,056018,C315
1771,CASTIGLIONE MESSER MARINO,CH,1545,737,808,3130230200,069020,C298
1772,CASTIGLIONE MESSER RAIMONDO,TE,2052,1044,1008,3130790120,067013,C316
1773,CASTIGLIONE OLONA,VA,7582,3772,3810,1030860390,012046,C300
1774,CASTIGLIONE TINELLA,CN,811,400,411,1010270560,004056,C317
1775,CASTIGLIONE TORINESE,TO,6469,3209,3260,1010810670,001068,C307
1776,CASTIGNANO,AP,2582,1278,1304,2110060120,044012,C321
1777,CASTILENTI,TE,1373,717,656,3130790130,067014,C322
1778,CASTINO,CN,458,245,213,1010270570,004057,C323
1779,CASTIONE ANDEVENNO,SO,1533,771,762,1030770150,014015,C325
1780,CASTIONE DELLA PRESOLANA,BG,3353,1683,1670,1030120620,016064,C324
1781,CASTIONS DI STRADA,UD,3694,1810,1884,1060850200,030020,C327
1782,CASTIRAGA VIDARDO,LO,2952,1500,1452,1030990150,098015,C329
1783,CASTO,BS,1625,840,785,1030150400,017044,C330
1784,CASTORANO,AP,2251,1096,1155,2110060130,044013,C331
1785,CASTREZZATO,BS,7494,3752,3742,1030150410,017045,C332
1786,CASTRI DI LECCE,LE,2789,1378,1411,3160410160,075017,C334
1787,CASTRIGNANO DE' GRECI,LE,3727,1796,1931,3160410170,075018,C335
1788,CASTRIGNANO DEL CAPO,LE,5143,2456,2687,3160410180,075019,C336
1789,CASTRO,BG,1232,613,619,1030120630,016065,C337
1790,CASTRO,BG,1232,613,619,3160410181,075096,M261
1791,CASTRO,LE,2365,1119,1246,1030120630,016065,C337
1792,CASTRO,LE,2365,1119,1246,3160410181,075096,M261
1793,CASTRO DEI VOLSCI,FR,4519,2199,2320,2120330230,060023,C338
1794,CASTROCARO TERME E TERRA DEL SOLE,FC,6272,3060,3212,1080320040,040005,C339
1795,CASTROCIELO,FR,3848,1863,1985,2120330220,060022,C340
1796,CASTROFILIPPO,AG,2645,1245,1400,4190010130,084013,C341
1797,CASTROLIBERO,CS,9296,4434,4862,3180250310,078031,C108
1798,CASTRONNO,VA,5039,2519,2520,1030860400,012047,C343
1799,CASTRONOVO DI SICILIA,PA,2865,1381,1484,4190550230,082025,C344
1800,CASTRONUOVO DI SANT'ANDREA,PZ,929,444,485,3170640260,076026,C345
1801,CASTROPIGNANO,CB,874,419,455,3140190160,070016,C346
1802,CASTROREALE,ME,2244,1100,1144,4190480160,083016,C347
1803,CASTROREGIO,CS,239,134,105,3180250320,078032,C348
1804,CASTROVILLARI,CS,20932,10080,10852,3180250330,078033,C349
1805,CATANIA,CT,301104,144999,156105,4190210150,087015,C351
1806,CATANZARO,CZ,85609,40854,44755,3180220220,079023,C352
1807,CATENANUOVA,EN,4546,2221,2325,4190280060,086006,C353
1808,CATIGNANO,PE,1236,625,611,3130600100,068010,C354
1809,CATTOLICA,RN,16569,7813,8756,1081010020,099002,C357
1810,CATTOLICA ERACLEA,AG,3325,1635,1690,4190010140,084014,C356
1811,CAULONIA,RC,6739,3289,3450,3180670250,080025,C285
1812,CAUTANO,BN,1950,994,956,3150110210,062021,C359
1813,CAVA DE' TIRRENI,SA,51067,24739,26328,3150720370,065037,C361
1814,CAVA MANARA,PV,6649,3213,3436,1030570390,018041,C360
1815,CAVAGLIA',BI,3546,1789,1757,1010960160,096016,C363
1816,CAVAGLIETTO,NO,381,196,185,1010520430,003044,C364
1817,CAVAGLIO D'AGOGNA,NO,1165,576,589,1010520440,003045,C365
1818,CAVAGNOLO,TO,2226,1102,1124,1010810671,001069,C369
1819,CAVAION VERONESE,VR,6067,2993,3074,1050890230,023023,C370
1820,CAVALESE,TN,4039,1948,2091,1040830470,022050,C372
1821,CAVALLERLEONE,CN,673,350,323,1010270580,004058,C375
1822,CAVALLERMAGGIORE,CN,5333,2657,2676,1010270590,004059,C376
1823,CAVALLINO,LE,12839,6224,6615,3160410190,075020,C377
1824,CAVALLINO-TREPORTI,VE,13384,6544,6840,1050870054,027044,M308
1825,CAVALLIRIO,NO,1307,652,655,1010520460,003047,C378
1826,CAVARENO,TN,1138,597,541,1040830480,022051,C380
1827,CAVARGNA,CO,189,96,93,1030240590,013062,C381
1828,CAVARIA CON PREMEZZO,VA,5638,2841,2797,1030860410,012048,C382
1829,CAVARZERE,VE,12962,6375,6587,1050870060,027006,C383
1830,CAVASO DEL TOMBA,TV,2872,1412,1460,1050840140,026014,C384
1831,CAVASSO NUOVO,PN,1501,741,760,1060930120,093012,C385
1832,CAVATORE,AL,261,119,142,1010020530,006055,C387
1833,CAVAZZO CARNICO,UD,937,458,479,1060850210,030021,C389
1834,CAVE,RM,10781,5386,5395,2120700260,058026,C390
1835,CAVEDAGO,TN,563,298,265,1040830490,022052,C392
1836,CAVEDINE,TN,3025,1536,1489,1040830500,022053,C393
1837,CAVENAGO D'ADDA,LO,2098,1042,1056,1030990170,098017,C394
1838,CAVENAGO DI BRIANZA,MB,7400,3685,3715,1031040170,108017,C395
1839,CAVERNAGO,BG,2720,1372,1348,1030120640,016066,C396
1840,CAVEZZO,MO,6997,3395,3602,1080500090,036009,C398
1841,CAVIZZANA,TN,247,119,128,1040830501,022054,C400
1842,CAVOUR,TO,5374,2667,2707,1010810680,001070,C404
1843,CAVRIAGO,RE,9835,4771,5064,1080680170,035017,C405
1844,CAVRIANA,MN,3747,1841,1906,1030450180,020018,C406
1845,CAVRIGLIA,AR,9462,4733,4729,2090050130,051013,C407
1846,CAZZAGO BRABBIA,VA,802,405,397,1030860420,012049,C409
1847,CAZZAGO SAN MARTINO,BS,10749,5323,5426,1030150420,017046,C408
1848,CAZZANO DI TRAMIGNA,VR,1508,743,765,1050890240,023024,C412
1849,CAZZANO SANT'ANDREA,BG,1640,828,812,1030120641,016067,C410
1850,CECCANO,FR,22501,10994,11507,2120330240,060024,C413
1851,CECIMA,PV,244,127,117,1030570391,018042,C414
1852,CECINA,LI,27898,13261,14637,2090420070,049007,C415
1853,CEDEGOLO,BS,1098,540,558,1030150430,017047,C417
1854,CEDRASCO,SO,422,203,219,1030770160,014016,C418
1855,CEFALA' DIANA,PA,987,494,493,4190550240,082026,C420
1856,CEFALU',PA,13958,6771,7187,4190550250,082027,C421
1857,CEGGIA,VE,6146,3048,3098,1050870070,027007,C422
1858,CEGLIE MESSAPICA,BR,18880,9040,9840,3160160030,074003,C424
1859,CELANO,AQ,10379,5277,5102,3130380320,066032,C426
1860,CELENZA SUL TRIGNO,CH,802,392,410,3130230210,069021,C428
1861,CELENZA VALFORTORE,FG,1403,669,734,3160310170,071018,C429
1862,CELICO,CS,2534,1288,1246,3180250340,078034,C430
1863,CELLA DATI,CR,486,240,246,1030260270,019028,C435
1864,CELLA MONTE,AL,467,237,230,1010020540,006056,C432
1865,CELLAMARE,BA,5798,2839,2959,3160090180,072018,C436
1866,CELLARA,CS,480,243,237,3180250350,078035,C437
1867,CELLARENGO,AT,710,356,354,1010070330,005033,C438
1868,CELLATICA,BS,4862,2332,2530,1030150440,017048,C439
1869,CELLE DI BULGHERIA,SA,1773,853,920,3150720380,065038,C444
1870,CELLE DI MACRA,CN,84,51,33,1010270600,004060,C441
1871,CELLE DI SAN VITO,FG,147,73,74,3160310180,071019,C442
1872,CELLE ENOMONDO,AT,452,215,237,1010070340,005034,C440
1873,CELLE LIGURE,SV,4910,2363,2547,1070740220,009022,C443
1874,CELLENO,VT,1322,657,665,2120910180,056019,C446
1875,CELLERE,VT,1075,551,524,2120910190,056020,C447
1876,CELLINO ATTANASIO,TE,2274,1136,1138,3130790140,067015,C449
1877,CELLINO SAN MARCO,BR,6170,2924,3246,3160160040,074004,C448
1878,CELLIO CON BREIA,VC,940,466,474,1010880385,002171,M398
1879,CELLOLE,CE,8086,3928,4158,3150200271,061102,M262
1880,CEMBRA LISIGNAGO,TN,2296,1181,1115,1040830515,022241,M355
1881,CENADI,CZ,507,249,258,3180220230,079024,C453
1882,CENATE SOPRA,BG,2515,1278,1237,1030120650,016068,C456
1883,CENATE SOTTO,BG,3928,1968,1960,1030120660,016069,C457
1884,CENCENIGHE AGORDINO,BL,1243,613,630,1050100100,025010,C458
1885,CENE,BG,4095,2043,2052,1030120670,016070,C459
1886,CENESELLI,RO,1552,770,782,1050710140,029014,C461
1887,CENGIO,SV,3293,1625,1668,1070740230,009023,C463
1888,CENTALLO,CN,6875,3519,3356,1010270610,004061,C466
1889,CENTO,FE,35228,17346,17882,1080290040,038004,C469
1890,CENTOLA,SA,5020,2585,2435,3150720390,065039,C470
1891,CENTRACHE,CZ,340,170,170,3180220240,079025,C472
1892,CENTRO VALLE INTELVI,CO,3573,1757,1816,1030240595,013254,M394
1893,CENTURIPE,EN,5129,2521,2608,4190280070,086007,C471
1894,CEPAGATTI,PE,10960,5384,5576,3130600110,068011,C474
1895,CEPPALONI,BN,3231,1597,1634,3150110220,062022,C476
1896,CEPPO MORELLI,VB,301,156,145,1011020210,103021,C478
1897,CEPRANO,FR,8260,4072,4188,2120330250,060025,C479
1898,CERAMI,EN,1867,911,956,4190280080,086008,C480
1899,CERANESI,GE,3637,1845,1792,1070340140,010014,C481
1900,CERANO,NO,6712,3291,3421,1010520480,003049,C483
1901,CERANO D'INTELVI,CO,572,279,293,1030240600,013063,C482
1902,CERANOVA,PV,2283,1147,1136,1030570400,018043,C484
1903,CERASO,SA,2268,1119,1149,3150720400,065040,C485
1904,CERCEMAGGIORE,CB,3594,1824,1770,3140190170,070017,C486
1905,CERCENASCO,TO,1782,872,910,1010810690,001071,C487
1906,CERCEPICCOLA,CB,610,282,328,3140190180,070018,C488
1907,CERCHIARA DI CALABRIA,CS,2184,1094,1090,3180250360,078036,C489
1908,CERCHIO,AQ,1569,780,789,3130380330,066033,C492
1909,CERCINO,SO,782,397,385,1030770170,014017,C493
1910,CERCIVENTO,UD,652,323,329,1060850220,030022,C494
1911,CERCOLA,,17124,8236,8888,3150510260,063026,C495
1912,CERDA,PA,4942,2436,2506,4190550260,082028,C496
1913,CEREA,VR,16751,8260,8491,1050890250,023025,C498
1914,CEREGNANO,RO,3440,1672,1768,1050710150,029015,C500
1915,CERENZIA,KR,1035,515,520,3180970060,101006,C501
1916,CERES,TO,1017,535,482,1010810700,001072,C497
1917,CERESARA,MN,2554,1301,1253,1030450190,020019,C502
1918,CERESETO,AL,396,206,190,1010020550,006057,C503
1919,CERESOLE ALBA,CN,2006,1021,985,1010270620,004062,C504
1920,CERESOLE REALE,TO,159,86,73,1010810710,001073,C505
1921,CERETE,BG,1597,784,813,1030120680,016071,C506
1922,CERETTO LOMELLINA,PV,178,83,95,1030570401,018044,C508
1923,CERGNAGO,PV,681,336,345,1030570410,018045,C509
1924,CERIALE,SV,5365,2611,2754,1070740240,009024,C510
1925,CERIANA,IM,1099,576,523,1070370150,008016,C511
1926,CERIANO LAGHETTO,MB,6645,3291,3354,1031040180,108018,C512
1927,CERIGNALE,PC,117,67,50,1080610150,033015,C513
1928,CERIGNOLA,FG,57127,28348,28779,3160310190,071020,C514
1929,CERISANO,CS,2939,1467,1472,3180250370,078037,C515
1930,CERMENATE,CO,9274,4567,4707,1030240610,013064,C516
1931,CERMES/TSCHERMS,BZ,1564,782,782,1040140170,021020,A022
1932,CERMIGNANO,TE,1459,716,743,3130790150,067016,C517
1933,CERNOBBIO,CO,6402,3085,3317,1030240620,013065,C520
1934,CERNUSCO LOMBARDONE,LC,3808,1860,1948,1030980200,097020,C521
1935,CERNUSCO SUL NAVIGLIO,MI,34969,16823,18146,1030490700,015070,C523
1936,CERRETO D'ASTI,AT,222,115,107,1010070350,005035,C528
1937,CERRETO D'ESI,AN,3415,1712,1703,2110030130,042013,C524
1938,CERRETO DI SPOLETO,PG,985,481,504,2100580100,054010,C527
1939,CERRETO GRUE,AL,302,149,153,1010020560,006058,C507
1940,CERRETO GUIDI,FI,10794,5262,5532,2090300110,048011,C529
1941,CERRETO LAZIALE,RM,1104,544,560,2120700270,058027,C518
1942,CERRETO SANNITA,BN,3630,1789,1841,3150110230,062023,C525
1943,CERRETTO LANGHE,CN,402,217,185,1010270630,004063,C530
1944,CERRINA MONFERRATO,AL,1309,643,666,1010020570,006059,C531
1945,CERRIONE,BI,2810,1369,1441,1010960180,096018,C532
1946,CERRO AL LAMBRO,MI,5090,2514,2576,1030490710,015071,C536
1947,CERRO AL VOLTURNO,IS,1155,590,565,3140940140,094014,C534
1948,CERRO MAGGIORE,MI,14984,7304,7680,1030490720,015072,C537
1949,CERRO TANARO,AT,588,292,296,1010070360,005036,C533
1950,CERRO VERONESE,VR,2581,1304,1277,1050890260,023026,C538
1951,CERSOSIMO,PZ,541,264,277,3170640270,076027,C539
1952,CERTALDO,FI,15483,7641,7842,2090300120,048012,C540
1953,CERTOSA DI PAVIA,PV,5455,2740,2715,1030570430,018046,C541
1954,CERVA,CZ,1106,521,585,3180220260,079027,C542
1955,CERVARA DI ROMA,RM,441,242,199,2120700280,058028,C543
1956,CERVARESE SANTA CROCE,PD,5652,2811,2841,1050540300,028030,C544
1957,CERVARO,FR,7812,3839,3973,2120330260,060026,C545
1958,CERVASCA,CN,5148,2613,2535,1010270640,004064,C547
1959,CERVATTO,VC,50,32,18,1010880410,002041,C548
1960,CERVENO,BS,657,345,312,1030150450,017049,C549
1961,CERVERE,CN,2255,1113,1142,1010270650,004065,C550
1962,CERVESINA,PV,1133,520,613,1030570440,018047,C551
1963,CERVETERI,RM,37741,18637,19104,2120700290,058029,C552
1964,CERVIA,RA,28758,13826,14932,1080660070,039007,C553
1965,CERVICATI,CS,786,389,397,3180250380,078038,C554
1966,CERVIGNANO D'ADDA,LO,2184,1091,1093,1030990180,098018,C555
1967,CERVIGNANO DEL FRIULI,UD,13546,6692,6854,1060850230,030023,C556
1968,CERVINARA,AV,8796,4275,4521,3150080250,064025,C557
1969,CERVINO,CE,4805,2353,2452,3150200280,061028,C558
1970,CERVO,IM,1118,533,585,1070370160,008017,C559
1971,CERZETO,CS,1228,614,614,3180250390,078039,C560
1972,CESA,CE,9444,4714,4730,3150200290,061029,C561
1973,CESANA BRIANZA,LC,2384,1179,1205,1030980210,097021,C563
1974,CESANA TORINESE,TO,913,495,418,1010810720,001074,C564
1975,CESANO BOSCONE,MI,23520,11435,12085,1030490740,015074,C565
1976,CESANO MADERNO,MB,39042,19483,19559,1031040190,108019,C566
1977,CESARA,VB,597,287,310,1011020220,103022,C567
1978,CESARO',ME,2204,1079,1125,4190480170,083017,C568
1979,CESATE,MI,14218,6971,7247,1030490760,015076,C569
1980,CESENA,FC,96168,46694,49474,1080320060,040007,C573
1981,CESENATICO,FC,25958,12576,13382,1080320070,040008,C574
1982,CESINALI,AV,2565,1279,1286,3150080260,064026,C576
1983,CESIO,IM,273,150,123,1070370170,008018,C578
1984,CESIOMAGGIORE,BL,3919,1987,1932,1050100110,025011,C577
1985,CESSALTO,TV,3776,1888,1888,1050840150,026015,C580
1986,CESSANITI,VV,2999,1502,1497,3181030060,102006,C581
1987,CESSAPALOMBO,MC,439,202,237,2110440110,043011,C582
1988,CESSOLE,AT,362,182,180,1010070370,005037,C583
1989,CETARA,SA,1997,998,999,3150720410,065041,C584
1990,CETO,BS,1788,889,899,1030150460,017050,C585
1991,CETONA,SI,2516,1199,1317,2090750080,052008,C587
1992,CETRARO,CS,9496,4702,4794,3180250400,078040,C588
1993,CEVA,CN,5641,2792,2849,1010270660,004066,C589
1994,CEVO,BS,820,430,390,1030150461,017051,C591
1995,CHALLAND-SAINT-ANSELME,AO,742,369,373,1020040130,007013,C593
1996,CHALLAND-SAINT-VICTOR,AO,547,266,281,1020040140,007014,C594
1997,CHAMBAVE,AO,886,436,450,1020040150,007015,C595
1998,CHAMOIS,AO,109,60,49,1020040160,007016,B491
1999,CHAMPDEPRAZ,AO,717,338,379,1020040170,007017,C596
2000,CHAMPORCHER,AO,374,189,185,1020040180,007018,B540
2001,CHARVENSOD,AO,2367,1158,1209,1020040190,007019,C598
2002,CHATILLON,AO,4402,2139,2263,1020040200,007020,C294
2003,CHERASCO,CN,9447,4668,4779,1010270670,004067,C599
2004,CHEREMULE,SS,402,199,203,4200730240,090024,C600
2005,CHIALAMBERTO,TO,344,168,176,1010810730,001075,C604
2006,CHIAMPO,VI,12534,6404,6130,1050900290,024029,C605
2007,CHIANCHE,AV,468,243,225,3150080270,064027,C606
2008,CHIANCIANO TERME,SI,6848,3309,3539,2090750090,052009,C608
2009,CHIANNI,PI,1315,660,655,2090620120,050012,C609
2010,CHIANOCCO,TO,1552,765,787,1010810740,001076,C610
2011,CHIARAMONTE GULFI,RG,8024,4069,3955,4190650020,088002,C612
2012,CHIARAMONTI,SS,1525,750,775,4200730250,090025,C613
2013,CHIARANO,TV,3665,1870,1795,1050840160,026016,C614
2014,CHIARAVALLE,AN,14306,6739,7567,2110030140,042014,C615
2015,CHIARAVALLE CENTRALE,CZ,5138,2432,2706,3180220280,079029,C616
2016,CHIARI,BS,19131,9522,9609,1030150470,017052,C618
2017,CHIAROMONTE,PZ,1765,855,910,3170640280,076028,C619
2018,CHIAUCI,IS,206,110,96,3140940150,094015,C620
2019,CHIAVARI,GE,27228,12593,14635,1070340150,010015,C621
2020,CHIAVENNA,SO,7235,3419,3816,1030770180,014018,C623
2021,CHIAVERANO,TO,1985,964,1021,1010810750,001077,C624
2022,CHIENES/KIENS,BZ,2986,1526,1460,1040140180,021021,C625
2023,CHIERI,TO,35916,17279,18637,1010810760,001078,C627
2024,CHIES D'ALPAGO,BL,1256,619,637,1050100120,025012,C630
2025,CHIESA IN VALMALENCO,SO,2350,1156,1194,1030770190,014019,C628
2026,CHIESANUOVA,TO,231,120,111,1010810770,001079,C629
2027,CHIESINA UZZANESE,PT,4468,2202,2266,2090630031,047022,C631
2028,CHIETI,CH,48666,23276,25390,3130230220,069022,C632
2029,CHIEUTI,FG,1563,772,791,3160310200,071021,C633
2030,CHIEVE,CR,2235,1120,1115,1030260280,019029,C634
2031,CHIGNOLO D'ISOLA,BG,3364,1744,1620,1030120690,016072,C635
2032,CHIGNOLO PO,PV,3932,1986,1946,1030570450,018048,C637
2033,CHIOGGIA,VE,47903,23774,24129,1050870080,027008,C638
2034,CHIOMONTE,TO,870,426,444,1010810780,001080,C639
2035,CHIONS,PN,5100,2522,2578,1060930130,093013,C640
2036,CHIOPRIS-VISCONE,UD,682,328,354,1060850240,030024,C641
2037,CHITIGNANO,AR,866,426,440,2090050140,051014,C648
2038,CHIUDUNO,BG,6067,3060,3007,1030120700,016073,C649
2039,CHIUPPANO,VI,2496,1245,1251,1050900300,024030,C650
2040,CHIURO,SO,2426,1152,1274,1030770200,014020,C651
2041,CHIUSA DI PESIO,CN,3548,1764,1784,1010270680,004068,C653
2042,CHIUSA DI SAN MICHELE,TO,1556,780,776,1010810790,001081,C655
2043,CHIUSA SCLAFANI,PA,2577,1208,1369,4190550270,082029,C654
2044,CHIUSA/KLAUSEN,BZ,5218,2609,2609,1040140190,021022,C652
2045,CHIUSAFORTE,UD,614,323,291,1060850250,030025,C656
2046,CHIUSANICO,IM,593,313,280,1070370180,008019,C657
2047,CHIUSANO D'ASTI,AT,250,123,127,1010070380,005038,C658
2048,CHIUSANO DI SAN DOMENICO,AV,2110,1030,1080,3150080280,064028,C659
2049,CHIUSAVECCHIA,IM,513,261,252,1070370190,008020,C660
2050,CHIUSDINO,SI,1767,871,896,2090750100,052010,C661
2051,CHIUSI,SI,8051,3923,4128,2090750110,052011,C662
2052,CHIUSI DELLA VERNA,AR,1889,939,950,2090050150,051015,C663
2053,CHIVASSO,TO,26275,12657,13618,1010810800,001082,C665
2054,CIAMPINO,RM,38519,18399,20120,2120700291,058118,M272
2055,CIANCIANA,AG,3159,1503,1656,4190010150,084015,C668
2056,CIBIANA DI CADORE,BL,350,164,186,1050100130,025013,C672
2057,CICAGNA,GE,2250,1149,1101,1070340160,010016,C673
2058,CICALA,CZ,893,435,458,3180220290,079030,C674
2059,CICCIANO,,12311,5990,6321,3150510270,063027,C675
2060,CICERALE,SA,1169,580,589,3150720420,065042,C676
2061,CICILIANO,RM,1255,644,611,2120700300,058030,C677
2062,CICOGNOLO,CR,915,456,459,1030260290,019030,C678
2063,CICONIO,TO,364,188,176,1010810810,001083,C679
2064,CIGLIANO,VC,4295,2085,2210,1010880420,002042,C680
2065,CIGLIE',CN,183,91,92,1010270690,004069,C681
2066,CIGOGNOLA,PV,1312,623,689,1030570460,018049,C684
2067,CIGOLE,BS,1441,710,731,1030150480,017053,C685
2068,CILAVEGNA,PV,5308,2616,2692,1030570470,018050,C686
2069,CIMADOLMO,TV,3343,1687,1656,1050840170,026017,C689
2070,CIMBERGO,BS,543,277,266,1030150490,017054,C691
2071,CIMINA',RC,530,272,258,3180670260,080026,C695
2072,CIMINNA,PA,3466,1678,1788,4190550280,082030,C696
2073,CIMITILE,,6940,3337,3603,3150510280,063028,C697
2074,CIMOLAIS,PN,343,178,165,1060930140,093014,C699
2075,CIMONE,TN,722,376,346,1040830540,022058,C700
2076,CINAGLIO,AT,423,215,208,1010070390,005039,C701
2077,CINETO ROMANO,RM,575,278,297,2120700310,058031,C702
2078,CINGIA DE' BOTTI,CR,1149,590,559,1030260300,019031,C703
2079,CINGOLI,MC,9679,4729,4950,2110440120,043012,C704
2080,CINIGIANO,GR,2390,1217,1173,2090360060,053007,C705
2081,CINISELLO BALSAMO,MI,74391,36512,37879,1030490770,015077,C707
2082,CINISI,PA,11941,5884,6057,4190550290,082031,C708
2083,CINO,SO,333,175,158,1030770210,014021,C709
2084,CINQUEFRONDI,RC,6269,3048,3221,3180670270,080027,C710
2085,CINTANO,TO,240,125,115,1010810820,001084,C711
2086,CINTE TESINO,TN,338,173,165,1040830550,022059,C712
2087,CINTO CAOMAGGIORE,VE,3114,1535,1579,1050870090,027009,C714
2088,CINTO EUGANEO,PD,1928,975,953,1050540310,028031,C713
2089,CINZANO,TO,323,165,158,1010810830,001085,C715
2090,CIORLANO,CE,372,187,185,3150200300,061030,C716
2091,CIPRESSA,IM,1181,578,603,1070370200,008021,C718
2092,CIRCELLO,BN,2183,1087,1096,3150110240,062024,C719
2093,CIRIE',TO,18212,8743,9469,1010810840,001086,C722
2094,CIRIGLIANO,MT,290,129,161,3170470050,077005,C723
2095,CIRIMIDO,CO,2121,1080,1041,1030240650,013068,C724
2096,CIRO',KR,2534,1204,1330,3180970070,101007,C725
2097,CIRO' MARINA,KR,14002,6831,7171,3180970080,101008,C726
2098,CIS,TN,304,145,159,1040830560,022060,C727
2099,CISANO BERGAMASCO,BG,6158,3061,3097,1030120710,016074,C728
2100,CISANO SUL NEVA,SV,2122,1050,1072,1070740250,009025,C729
2101,CISERANO,BG,5484,2849,2635,1030120720,016075,C730
2102,CISLAGO,VA,10413,5168,5245,1030860430,012050,C732
2103,CISLIANO,MI,5031,2506,2525,1030490780,015078,C733
2104,CISON DI VALMARINO,TV,2540,1249,1291,1050840180,026018,C735
2105,CISSONE,CN,80,48,32,1010270700,004070,C738
2106,CISTERNA D'ASTI,AT,1224,625,599,1010070400,005040,C739
2107,CISTERNA DI LATINA,LT,36536,18198,18338,2120400050,059005,C740
2108,CISTERNINO,BR,11231,5386,5845,3160160050,074005,C741
2109,CITERNA,PG,3428,1719,1709,2100580110,054011,C742
2110,CITTA' DELLA PIEVE,PG,7512,3596,3916,2100580120,054012,C744
2111,CITTA' DI CASTELLO,PG,38505,18508,19997,2100580130,054013,C745
2112,CITTA' SANT'ANGELO,PE,14799,7333,7466,3130600120,068012,C750
2113,CITTADELLA,PD,20076,9815,10261,1050540320,028032,C743
2114,CITTADUCALE,RI,6447,3163,3284,2120690150,057016,C746
2115,CITTANOVA,RC,9829,4784,5045,3180670280,080028,C747
2116,CITTAREALE,RI,413,216,197,2120690160,057017,C749
2117,CITTIGLIO,VA,3807,1880,1927,1030860440,012051,C751
2118,CIVATE,LC,3713,1845,1868,1030980220,097022,C752
2119,CIVEZZA,IM,628,307,321,1070370210,008022,C755
2120,CIVEZZANO,TN,4092,2055,2037,1040830570,022061,C756
2121,CIVIASCO,VC,234,124,110,1010880430,002043,C757
2122,CIVIDALE DEL FRIULI,UD,10875,5188,5687,1060850260,030026,C758
2123,CIVIDATE AL PIANO,BG,5036,2575,2461,1030120730,016076,C759
2124,CIVIDATE CAMUNO,BS,2655,1361,1294,1030150500,017055,C760
2125,CIVITA,CS,822,393,429,3180250420,078041,C763
2126,CIVITA CASTELLANA,VT,15416,7472,7944,2120910200,056021,C765
2127,CIVITA D'ANTINO,AQ,918,453,465,3130380340,066034,C766
2128,CIVITACAMPOMARANO,CB,314,141,173,3140190190,070019,C764
2129,CIVITALUPARELLA,CH,292,153,139,3130230230,069023,C768
2130,CIVITANOVA DEL SANNIO,IS,890,445,445,3140940160,094016,C769
2131,CIVITANOVA MARCHE,MC,41768,19954,21814,2110440130,043013,C770
2132,CIVITAQUANA,PE,1169,595,574,3130600130,068013,C771
2133,CIVITAVECCHIA,RM,51880,24964,26916,2120700320,058032,C773
2134,CIVITELLA ALFEDENA,AQ,287,145,142,3130380350,066035,C778
2135,CIVITELLA CASANOVA,PE,1605,791,814,3130600140,068014,C779
2136,CIVITELLA D'AGLIANO,VT,1493,741,752,2120910210,056022,C780
2137,CIVITELLA DEL TRONTO,TE,4601,2282,2319,3130790160,067017,C781
2138,CIVITELLA DI ROMAGNA,FC,3642,1799,1843,1080320080,040009,C777
2139,CIVITELLA IN VAL DI CHIANA,AR,8814,4384,4430,2090050160,051016,C774
2140,CIVITELLA MESSER RAIMONDO,CH,790,393,397,3130230240,069024,C776
2141,CIVITELLA PAGANICO,GR,2989,1520,1469,2090360070,053008,C782
2142,CIVITELLA ROVETO,AQ,3069,1564,1505,3130380360,066036,C783
2143,CIVITELLA SAN PAOLO,RM,1989,1000,989,2120700330,058033,C784
2144,CIVO,SO,1118,577,541,1030770220,014022,C785
2145,CLAINO CON OSTENO,CO,539,281,258,1030240680,013071,C787
2146,CLAUT,PN,883,438,445,1060930150,093015,C790
2147,CLAUZETTO,PN,372,205,167,1060930160,093016,C791
2148,CLAVESANA,CN,799,387,412,1010270710,004071,C792
2149,CLAVIERE,TO,204,102,102,1010810850,001087,C793
2150,CLES,TN,7153,3432,3721,1040830580,022062,C794
2151,CLETO,CS,1194,629,565,3180250430,078042,C795
2152,CLIVIO,VA,1938,934,1004,1030860441,012052,C796
2153,CLUSONE,BG,8510,4127,4383,1030120740,016077,C800
2154,COASSOLO TORINESE,TO,1444,729,715,1010810860,001088,C801
2155,COAZZE,TO,3218,1626,1592,1010810870,001089,C803
2156,COAZZOLO,AT,293,150,143,1010070410,005041,C804
2157,COCCAGLIO,BS,8728,4394,4334,1030150510,017056,C806
2158,COCCONATO,AT,1406,714,692,1010070420,005042,C807
2159,COCQUIO-TREVISAGO,VA,4623,2225,2398,1030860450,012053,C810
2160,COCULLO,AQ,213,105,108,3130380370,066037,C811
2161,CODEVIGO,PD,6336,3255,3081,1050540330,028033,C812
2162,CODEVILLA,PV,942,450,492,1030570480,018051,C813
2163,CODIGORO,FE,11179,5358,5821,1080290050,038005,C814
2164,CODOGNE',TV,5225,2659,2566,1050840190,026019,C815
2165,CODOGNO,LO,15490,7464,8026,1030990190,098019,C816
2166,CODROIPO,UD,15877,7837,8040,1060850270,030027,C817
2167,CODRONGIANOS,SS,1283,624,659,4200730260,090026,C818
2168,COGGIOLA,BI,1651,816,835,1010960190,096019,C819
2169,COGLIATE,MB,8459,4161,4298,1031040200,108020,C820
2170,COGNE,AO,1315,653,662,1020040210,007021,C821
2171,COGOLETO,GE,8603,4152,4451,1070340170,010017,C823
2172,COGOLLO DEL CENGIO,VI,3156,1569,1587,1050900320,024032,C824
2173,COGORNO,GE,5724,2823,2901,1070340180,010018,C826
2174,COLAZZA,NO,530,276,254,1010520491,003051,C829
2175,COLCERESA,VI,5911,2907,3004,1050900325,024126,M426
2176,COLERE,BG,1108,565,543,1030120750,016078,C835
2177,COLFELICE,FR,1813,883,930,2120330270,060027,C836
2178,COLI,PC,832,430,402,1080610160,033016,C838
2179,COLICO,LC,7994,3970,4024,1030980230,097023,C839
2180,COLLALTO SABINO,RI,390,203,187,2120690170,057018,C841
2181,COLLARMELE,AQ,814,374,440,3130380380,066038,C844
2182,COLLAZZONE,PG,3365,1624,1741,2100580140,054014,C845
2183,COLLE BRIANZA,LC,1773,912,861,1030980240,097024,C851
2184,COLLE D'ANCHISE,CB,731,355,376,3140190200,070020,C854
2185,COLLE DI TORA,RI,362,197,165,2120690180,057019,C857
2186,COLLE DI VAL D'ELSA,SI,21677,10537,11140,2090750120,052012,C847
2187,COLLE SAN MAGNO,FR,636,319,317,2120330290,060029,C870
2188,COLLE SANNITA,BN,2209,1082,1127,3150110250,062025,C846
2189,COLLE SANTA LUCIA,BL,353,180,173,1050100140,025014,C872
2190,COLLE UMBERTO,TV,5071,2489,2582,1050840200,026020,C848
2191,COLLEBEATO,BS,4479,2165,2314,1030150520,017057,C850
2192,COLLECCHIO,PR,14556,7201,7355,1080560090,034009,C852
2193,COLLECORVINO,PE,5961,2973,2988,3130600150,068015,C853
2194,COLLEDARA,TE,2097,1044,1053,3130790170,067018,C311
2195,COLLEDIMACINE,CH,161,91,70,3130230250,069025,C855
2196,COLLEDIMEZZO,CH,439,223,216,3130230260,069026,C856
2197,COLLEFERRO,RM,20664,9990,10674,2120700340,058034,C858
2198,COLLEGIOVE,RI,130,71,59,2120690190,057020,C859
2199,COLLEGNO,TO,48574,23290,25284,1010810880,001090,C860
2200,COLLELONGO,AQ,1122,569,553,3130380390,066039,C862
2201,COLLEPARDO,FR,891,451,440,2120330280,060028,C864
2202,COLLEPASSO,LE,5685,2758,2927,3160410200,075021,C865
2203,COLLEPIETRO,AQ,200,97,103,3130380400,066040,C866
2204,COLLERETTO CASTELNUOVO,TO,312,155,157,1010810890,001091,C867
2205,COLLERETTO GIACOSA,TO,596,297,299,1010810900,001092,C868
2206,COLLESALVETTI,LI,16370,7989,8381,2090420080,049008,C869
2207,COLLESANO,PA,3691,1766,1925,4190550300,082032,C871
2208,COLLETORTO,CB,1692,820,872,3140190210,070021,C875
2209,COLLEVECCHIO,RI,1548,781,767,2120690200,057021,C876
2210,COLLI A VOLTURNO,IS,1271,632,639,3140940170,094017,C878
2211,COLLI AL METAURO,PU,12235,6142,6093,2110590125,041069,M380
2212,COLLI DEL TRONTO,AP,3624,1787,1837,2110060140,044014,C877
2213,COLLI SUL VELINO,RI,458,226,232,2120690201,057022,C880
2214,COLLI VERDI,PV,1018,524,494,1030570485,018193,M419
2215,COLLIANO,SA,3455,1689,1766,3150720430,065043,C879
2216,COLLINAS,SU,781,385,396,4201110120,111012,C882
2217,COLLIO,BS,2041,1048,993,1030150530,017058,C883
2218,COLLOBIANO,VC,86,40,46,1010880450,002045,C884
2219,COLLOREDO DI MONTE ALBANO,UD,2192,1081,1111,1060850280,030028,C885
2220,COLMURANO,MC,1185,577,608,2110440140,043014,C886
2221,COLOBRARO,MT,1070,540,530,3170470060,077006,C888
2222,COLOGNA VENETA,VR,8423,4194,4229,1050890270,023027,C890
2223,COLOGNE,BS,7562,3766,3796,1030150540,017059,C893
2224,COLOGNO AL SERIO,BG,11065,5603,5462,1030120760,016079,C894
2225,COLOGNO MONZESE,MI,46633,22586,24047,1030490810,015081,C895
2226,COLOGNOLA AI COLLI,VR,8770,4397,4373,1050890280,023028,C897
2227,COLONNA,RM,4231,2051,2180,2120700350,058035,C900
2228,COLONNELLA,TE,3627,1812,1815,3130790180,067019,C901
2229,COLONNO,CO,447,224,223,1030240710,013074,C902
2230,COLORINA,SO,1390,717,673,1030770230,014023,C903
2231,COLORNO,PR,8958,4458,4500,1080560100,034010,C904
2232,COLOSIMI,CS,1158,569,589,3180250440,078043,C905
2233,COLTURANO,MI,2041,1032,1009,1030490820,015082,C908
2234,COLVERDE,CO,5451,2678,2773,1030240715,013251,M336
2235,COLZATE,BG,1620,810,810,1030120770,016080,C910
2236,COMABBIO,VA,1221,618,603,1030860460,012054,C911
2237,COMACCHIO,FE,21989,10860,11129,1080290060,038006,C912
2238,COMANO,MS,662,326,336,2090460050,045005,C914
2239,COMANO TERME,TN,2913,1440,1473,1040830595,022228,M314
2240,COMAZZO,LO,2259,1167,1092,1030990200,098020,C917
2241,COMEGLIANS,UD,442,223,219,1060850290,030029,C918
2242,COMELICO SUPERIORE,BL,2089,1025,1064,1050100150,025015,C920
2243,COMERIO,VA,2835,1354,1481,1030860470,012055,C922
2244,COMEZZANO-CIZZAGO,BS,4029,2064,1965,1030150550,017060,C925
2245,COMIGNAGO,NO,1209,610,599,1010520500,003052,C926
2246,COMISO,RG,30073,14882,15191,4190650030,088003,C927
2247,COMITINI,AG,896,437,459,4190010160,084016,C928
2248,COMIZIANO,,1698,831,867,3150510290,063029,C929
2249,COMMESSAGGIO,MN,1090,533,557,1030450200,020020,C930
2250,COMMEZZADURA,TN,1008,501,507,1040830600,022064,C931
2251,COMO,CO,83361,40411,42950,1030240720,013075,C933
2252,COMPIANO,PR,1067,543,524,1080560110,034011,C934
2253,COMUN NUOVO,BG,4371,2221,2150,1030120780,016081,C937
2254,COMUNANZA,AP,2943,1472,1471,2110060150,044015,C935
2255,CONA,VE,2788,1364,1424,1050870100,027010,C938
2256,CONCA CASALE,IS,175,90,85,3140940180,094018,C941
2257,CONCA DEI MARINI,SA,674,349,325,3150720440,065044,C940
2258,CONCA DELLA CAMPANIA,CE,1165,573,592,3150200310,061031,C939
2259,CONCAMARISE,VR,1074,548,526,1050890290,023029,C943
2260,CONCERVIANO,RI,278,136,142,2120690210,057023,C946
2261,CONCESIO,BS,15623,7706,7917,1030150560,017061,C948
2262,CONCORDIA SAGITTARIA,VE,10224,4976,5248,1050870110,027011,C950
2263,CONCORDIA SULLA SECCHIA,MO,8172,3985,4187,1080500100,036010,C951
2264,CONCOREZZO,MB,15763,7698,8065,1031040210,108021,C952
2265,CONDOFURI,RC,4677,2281,2396,3180670290,080029,C954
2266,CONDOVE,TO,4437,2168,2269,1010810910,001093,C955
2267,CONDRO',ME,464,228,236,4190480180,083018,C956
2268,CONEGLIANO,TV,34274,16463,17811,1050840210,026021,C957
2269,CONFIENZA,PV,1545,768,777,1030570490,018052,C958
2270,CONFIGNI,RI,586,310,276,2120690220,057024,C959
2271,CONFLENTI,CZ,1295,640,655,3180220310,079033,C960
2272,CONIOLO,AL,445,230,215,1010020580,006060,C962
2273,CONSELICE,RA,9491,4657,4834,1080660080,039008,C963
2274,CONSELVE,PD,10011,4892,5119,1050540340,028034,C964
2275,CONTA',TN,1401,691,710,1040830621,022242,M356
2276,CONTESSA ENTELLINA,PA,1529,752,777,4190550310,082033,C968
2277,CONTIGLIANO,RI,3689,1865,1824,2120690230,057025,C969
2278,CONTRADA,AV,2961,1512,1449,3150080290,064029,C971
2279,CONTROGUERRA,TE,2236,1105,1131,3130790190,067020,C972
2280,CONTRONE,SA,791,403,388,3150720450,065045,C973
2281,CONTURSI TERME,SA,3255,1612,1643,3150720460,065046,C974
2282,CONVERSANO,BA,25784,12705,13079,3160090190,072019,C975
2283,CONZA DELLA CAMPANIA,AV,1286,632,654,3150080300,064030,C976
2284,CONZANO,AL,951,474,477,1010020590,006061,C977
2285,COPERTINO,LE,23159,11244,11915,3160410210,075022,C978
2286,COPIANO,PV,1708,861,847,1030570500,018053,C979
2287,COPPARO,FE,15753,7523,8230,1080290070,038007,C980
2288,CORANA,PV,765,381,384,1030570510,018054,C982
2289,CORATO,BA,47117,23027,24090,3160090200,072020,C983
2290,CORBARA,SA,2509,1217,1292,3150720470,065047,C984
2291,CORBETTA,MI,18763,9235,9528,1030490850,015085,C986
2292,CORBOLA,RO,2171,1033,1138,1050710170,029017,C987
2293,CORCHIANO,VT,3594,1830,1764,2120910220,056023,C988
2294,CORCIANO,PG,21429,10356,11073,2100580150,054015,C990
2295,CORDENONS,PN,17886,8761,9125,1060930170,093017,C991
2296,CORDIGNANO,TV,6900,3376,3524,1050840220,026022,C992
2297,CORDOVADO,PN,2726,1323,1403,1060930180,093018,C993
2298,COREGLIA ANTELMINELLI,LU,5096,2511,2585,2090430110,046011,C996
2299,COREGLIA LIGURE,GE,267,144,123,1070340190,010019,C995
2300,CORENO AUSONIO,FR,1545,762,783,2120330300,060030,C998
2301,CORFINIO,AQ,979,499,480,3130380410,066041,C999
2302,CORI,LT,10456,5179,5277,2120400060,059006,D003
2303,CORIANO,RN,10441,5198,5243,1081010030,099003,D004
2304,CORIGLIANO D'OTRANTO,LE,5697,2714,2983,3160410220,075023,D006
2305,CORIGLIANO-ROSSANO,CS,74173,36534,37639,3180250455,078157,M403
2306,CORINALDO,AN,4797,2319,2478,2110030150,042015,D007
2307,CORIO,TO,3048,1511,1537,1010810920,001094,D008
2308,CORLEONE,PA,10493,5176,5317,4190550320,082034,D009
2309,CORLETO MONFORTE,SA,523,257,266,3150720480,065048,D011
2310,CORLETO PERTICARA,PZ,2328,1160,1168,3170640290,076029,D010
2311,CORMANO,MI,20327,9788,10539,1030490860,015086,D013
2312,CORMONS,GO,7198,3407,3791,1060350020,031002,D014
2313,CORNA IMAGNA,BG,931,478,453,1030120790,016082,D015
2314,CORNALBA,BG,297,162,135,1030120791,016249,D016
2315,CORNALE E BASTIDA,PV,820,405,415,1030570521,018191,M338
2316,CORNAREDO,MI,20576,10066,10510,1030490870,015087,D018
2317,CORNATE D'ADDA,MB,10784,5413,5371,1031040215,108053,D019
2318,CORNEDO ALL'ISARCO/KARNEID,BZ,3433,1736,1697,1040140200,021023,B799
2319,CORNEDO VICENTINO,VI,11708,5924,5784,1050900340,024034,D020
2320,CORNEGLIANO LAUDENSE,LO,2834,1383,1451,1030990210,098021,D021
2321,CORNELIANO D'ALBA,CN,2142,1051,1091,1010270720,004072,D022
2322,CORNIGLIO,PR,1740,891,849,1080560120,034012,D026
2323,CORNO DI ROSAZZO,UD,3118,1548,1570,1060850300,030030,D027
2324,CORNO GIOVINE,LO,1139,536,603,1030990220,098022,D028
2325,CORNOVECCHIO,LO,207,109,98,1030990230,098023,D029
2326,CORNUDA,TV,6286,3096,3190,1050840230,026023,D030
2327,CORREGGIO,RE,25008,12302,12706,1080680200,035020,D037
2328,CORREZZANA,MB,3114,1550,1564,1031040220,108022,D038
2329,CORREZZOLA,PD,5055,2546,2509,1050540350,028035,D040
2330,CORRIDO,CO,847,422,425,1030240740,013077,D041
2331,CORRIDONIA,MC,14821,7267,7554,2110440150,043015,D042
2332,CORROPOLI,TE,5108,2515,2593,3130790200,067021,D043
2333,CORSANO,LE,5199,2581,2618,3160410230,075024,D044
2334,CORSICO,MI,34438,16512,17926,1030490930,015093,D045
2335,CORSIONE,AT,192,100,92,1010070440,005044,D046
2336,CORTACCIA SULLA STRADA DEL VINO/KURTATSCH AN DER WEINSTRASSE,BZ,2184,1083,1101,1040140210,021024,D048
2337,CORTALE,CZ,1889,913,976,3180220320,079034,D049
2338,CORTANDONE,AT,311,151,160,1010070450,005045,D050
2339,CORTANZE,AT,265,140,125,1010070460,005046,D051
2340,CORTAZZONE,AT,588,288,300,1010070470,005047,D052
2341,CORTE BRUGNATELLA,PC,535,264,271,1080610170,033017,D054
2342,CORTE DE' CORTESI CON CIGNONE,CR,1061,543,518,1030260310,019032,D056
2343,CORTE DE' FRATI,CR,1311,671,640,1030260320,019033,D057
2344,CORTE FRANCA,BS,7147,3586,3561,1030150570,017062,D058
2345,CORTE PALASIO,LO,1529,783,746,1030990240,098024,D068
2346,CORTEMAGGIORE,PC,4610,2341,2269,1080610180,033018,D061
2347,CORTEMILIA,CN,2188,1061,1127,1010270730,004073,D062
2348,CORTENO GOLGI,BS,1922,963,959,1030150580,017063,D064
2349,CORTENOVA,LC,1147,568,579,1030980250,097025,D065
2350,CORTENUOVA,BG,1953,972,981,1030120800,016083,D066
2351,CORTEOLONA E GENZONE,PV,2534,1248,1286,1030570531,018192,M372
2352,CORTIGLIONE,AT,536,269,267,1010070480,005048,D072
2353,CORTINA D'AMPEZZO,BL,5627,2645,2982,1050100160,025016,A266
2354,CORTINA SULLA STRADA DEL VINO/KURTINIG AN DER WEINSTRASSE,BZ,661,331,330,1040140220,021025,D075
2355,CORTINO,TE,601,325,276,3130790210,067022,D076
2356,CORTONA,AR,21324,10301,11023,2090050170,051017,D077
2357,CORVARA,PE,206,94,112,3130600160,068016,D078
2358,CORVARA IN BADIA/CORVARA,BZ,1392,679,713,1040140230,021026,D079
2359,CORVINO SAN QUIRICO,PV,972,465,507,1030570540,018057,D081
2360,CORZANO,BS,1419,706,713,1030150590,017064,D082
2361,COSEANO,UD,2045,996,1049,1060850310,030031,D085
2362,COSENZA,CS,64073,30129,33944,3180250460,078045,D086
2363,COSIO D'ARROSCIA,IM,175,81,94,1070370220,008023,D087
2364,COSIO VALTELLINO,SO,5482,2745,2737,1030770240,014024,D088
2365,COSOLETO,RC,795,391,404,3180670300,080030,D089
2366,COSSANO BELBO,CN,901,460,441,1010270740,004074,D093
2367,COSSANO CANAVESE,TO,440,220,220,1010810930,001095,D092
2368,COSSATO,BI,14015,6682,7333,1010960200,096020,D094
2369,COSSERIA,SV,1053,521,532,1070740260,009026,D095
2370,COSSIGNANO,AP,861,411,450,2110060160,044016,D096
2371,COSSOGNO,VB,668,346,322,1011020230,103023,D099
2372,COSSOINE,SS,765,383,382,4200730270,090027,D100
2373,COSSOMBRATO,AT,518,255,263,1010070490,005049,D101
2374,COSTA DE' NOBILI,PV,380,195,185,1030570550,018058,D109
2375,COSTA DI MEZZATE,BG,3317,1692,1625,1030120810,016084,D110
2376,COSTA DI ROVIGO,RO,2448,1165,1283,1050710180,029018,D105
2377,COSTA MASNAGA,LC,4758,2392,2366,1030980260,097026,D112
2378,COSTA SERINA,BG,866,443,423,1030120811,016247,D111
2379,COSTA VALLE IMAGNA,BG,547,278,269,1030120820,016085,D103
2380,COSTA VESCOVATO,AL,316,166,150,1010020600,006062,D102
2381,COSTA VOLPINO,BG,8922,4379,4543,1030120830,016086,D117
2382,COSTABISSARA,VI,7656,3795,3861,1050900350,024035,D107
2383,COSTACCIARO,PG,1110,542,568,2100580160,054016,D108
2384,COSTANZANA,VC,761,368,393,1010880470,002047,D113
2385,COSTARAINERA,IM,777,386,391,1070370221,008024,D114
2386,COSTERMANO SUL GARDA,VR,3933,1976,1957,1050890300,023030,D118
2387,COSTIGLIOLE D'ASTI,AT,5679,2823,2856,1010070500,005050,D119
2388,COSTIGLIOLE SALUZZO,CN,3295,1689,1606,1010270750,004075,D120
2389,COTIGNOLA,RA,7353,3594,3759,1080660090,039009,D121
2390,COTRONEI,KR,5261,2565,2696,3180970090,101009,D123
2391,COTTANELLO,RI,530,282,248,2120690240,057026,D124
2392,COURMAYEUR,AO,2615,1306,1309,1020040220,007022,D012
2393,COVO,BG,4218,2149,2069,1030120840,016087,D126
2394,COZZO,PV,355,186,169,1030570560,018059,D127
2395,CRACO,MT,644,325,319,3170470070,077007,D128
2396,CRANDOLA VALSASSINA,LC,269,142,127,1030980270,097027,D131
2397,CRAVAGLIANA,VC,268,144,124,1010880480,002048,D132
2398,CRAVANZANA,CN,377,183,194,1010270760,004076,D133
2399,CRAVEGGIA,VB,758,394,364,1011020240,103024,D134
2400,CREAZZO,VI,11227,5480,5747,1050900360,024036,D136
2401,CRECCHIO,CH,2628,1314,1314,3130230270,069027,D137
2402,CREDARO,BG,3556,1790,1766,1030120850,016088,D139
2403,CREDERA RUBBIANO,CR,1551,777,774,1030260330,019034,D141
2404,CREMA,CR,33970,16396,17574,1030260340,019035,D142
2405,CREMELLA,LC,1679,828,851,1030980280,097028,D143
2406,CREMENAGA,VA,775,365,410,1030860480,012056,D144
2407,CREMENO,LC,1671,889,782,1030980290,097029,D145
2408,CREMIA,CO,691,336,355,1030240780,013083,D147
2409,CREMOLINO,AL,1012,507,505,1010020610,006063,D149
2410,CREMONA,CR,70841,34243,36598,1030260350,019036,D150
2411,CREMOSANO,CR,1725,884,841,1030260360,019037,D151
2412,CRESCENTINO,VC,7636,3837,3799,1010880490,002049,D154
2413,CRESPADORO,VI,1289,682,607,1050900370,024037,D156
2414,CRESPIATICA,LO,2192,1111,1081,1030990250,098025,D159
2415,CRESPINA LORENZANA,PI,5426,2699,2727,2090620131,050041,M328
2416,CRESPINO,RO,1733,837,896,1050710190,029019,D161
2417,CRESSA,NO,1604,783,821,1010520530,003055,D162
2418,CREVACUORE,BI,1390,666,724,1010960210,096021,D165
2419,CREVALCORE,BO,13598,6722,6876,1080130240,037024,D166
2420,CREVOLADOSSOLA,VB,4510,2202,2308,1011020250,103025,D168
2421,CRISPANO,,11884,5889,5995,3150510300,063030,D170
2422,CRISPIANO,TA,13231,6515,6716,3160780040,073004,D171
2423,CRISSOLO,CN,156,88,68,1010270770,004077,D172
2424,CROCEFIESCHI,GE,522,287,235,1070340200,010020,D175
2425,CROCETTA DEL MONTELLO,TV,6057,2991,3066,1050840250,026025,C670
2426,CRODO,VB,1419,705,714,1011020260,103026,D177
2427,CROGNALETO,TE,1119,622,497,3130790220,067023,D179
2428,CROPALATI,CS,1017,513,504,3180250470,078046,D180
2429,CROPANI,CZ,4657,2261,2396,3180220340,079036,D181
2430,CROSIA,CS,9630,4749,4881,3180250480,078047,D184
2431,CROSIO DELLA VALLE,VA,601,316,285,1030860490,012057,D185
2432,CROTONE,KR,59359,29352,30007,3180970100,101010,D122
2433,CROTTA D'ADDA,CR,620,320,300,1030260370,019038,D186
2434,CROVA,VC,372,185,187,1010880520,002052,D187
2435,CROVIANA,TN,691,349,342,1040830640,022068,D188
2436,CRUCOLI,KR,2781,1320,1461,3180970110,101011,D189
2437,CUASSO AL MONTE,VA,3574,1764,1810,1030860500,012058,D192
2438,CUCCARO VETERE,SA,538,241,297,3150720490,065049,D195
2439,CUCCIAGO,CO,3442,1729,1713,1030240790,013084,D196
2440,CUCEGLIO,TO,930,466,464,1010810940,001096,D197
2441,CUGGIONO,MI,8138,4023,4115,1030490960,015096,D198
2442,CUGLIATE-FABIASCO,VA,3070,1545,1525,1030860501,012059,D199
2443,CUGLIERI,OR,2487,1228,1259,4200950190,095019,D200
2444,CUGNOLI,PE,1350,666,684,3130600170,068017,D201
2445,CUMIANA,TO,7821,3921,3900,1010810950,001097,D202
2446,CUMIGNANO SUL NAVIGLIO,CR,408,214,194,1030260380,019039,D203
2447,CUNARDO,VA,2885,1430,1455,1030860510,012060,D204
2448,CUNEO,CN,55557,26777,28780,1010270780,004078,D205
2449,CUNICO,AT,437,217,220,1010070510,005051,D207
2450,CUORGNE',TO,9411,4631,4780,1010810960,001098,D208
2451,CUPELLO,CH,4748,2314,2434,3130230280,069028,D209
2452,CUPRA MARITTIMA,AP,5402,2620,2782,2110060170,044017,D210
2453,CUPRAMONTANA,AN,4420,2185,2235,2110030160,042016,D211
2454,CURA CARPIGNANO,PV,4915,2424,2491,1030570570,018060,B824
2455,CURCURIS,OR,311,155,156,4200950191,095077,D214
2456,CUREGGIO,NO,2576,1236,1340,1010520560,003058,D216
2457,CURIGLIA CON MONTEVIASCO,VA,156,85,71,1030860520,012061,D217
2458,CURINGA,CZ,6520,3201,3319,3180220370,079039,D218
2459,CURINO,BI,463,219,244,1010960230,096023,D219
2460,CURNO,BG,7453,3665,3788,1030120860,016089,D221
2461,CURON VENOSTA/GRAUN IM VINSCHGAU,BZ,2372,1219,1153,1040140240,021027,D222
2462,CURSI,LE,3891,1905,1986,3160410240,075025,D223
2463,CURTAROLO,PD,7138,3529,3609,1050540360,028036,D226
2464,CURTATONE,MN,14711,7116,7595,1030450210,020021,D227
2465,CURTI,CE,6698,3174,3524,3150200320,061032,D228
2466,CUSAGO,MI,4402,2199,2203,1030490970,015097,D229
2467,CUSANO MILANINO,MI,18869,8997,9872,1030490980,015098,D231
2468,CUSANO MUTRI,BN,3822,1927,1895,3150110260,062026,D230
2469,CUSINO,CO,218,114,104,1030240800,013085,D232
2470,CUSIO,BG,210,112,98,1030120870,016090,D233
2471,CUSTONACI,TP,5306,2649,2657,4190820080,081007,D234
2472,CUTRO,KR,9478,4697,4781,3180970120,101012,D236
2473,CUTROFIANO,LE,8721,4168,4553,3160410250,075026,D237
2474,CUVEGLIO,VA,3246,1582,1664,1030860521,012062,D238
2475,CUVIO,VA,1631,786,845,1030860530,012063,D239
2476,DAIRAGO,MI,6372,3119,3253,1030490981,015099,D244
2477,DALMINE,BG,23241,11543,11698,1030120880,016091,D245
2478,DAMBEL,TN,416,213,203,1040830670,022071,D246
2479,DANTA DI CADORE,BL,438,220,218,1050100170,025017,D247
2480,DARFO BOARIO TERME,BS,15546,7715,7831,1030150600,017065,D251
2481,DASA',VV,1113,548,565,3181030070,102007,D253
2482,DAVAGNA,GE,1857,973,884,1070340210,010021,D255
2483,DAVERIO,VA,3085,1495,1590,1030860540,012064,D256
2484,DAVOLI,CZ,5481,2721,2760,3180220400,079042,D257
2485,DAZIO,SO,482,226,256,1030770250,014025,D258
2486,DECIMOMANNU,CA,8336,4203,4133,4200170150,092015,D259
2487,DECIMOPUTZU,SU,4205,2130,2075,4201110130,111013,D260
2488,DECOLLATURA,CZ,2920,1462,1458,3180220410,079043,D261
2489,DEGO,SV,1856,907,949,1070740270,009027,D264
2490,DEIVA MARINA,SP,1292,622,670,1070390120,011012,D265
2491,DELEBIO,SO,3331,1696,1635,1030770260,014026,D266
2492,DELIA,CL,3903,1852,2051,4190180060,085006,D267
2493,DELIANUOVA,RC,3125,1490,1635,3180670310,080031,D268
2494,DELICETO,FG,3563,1770,1793,3160310210,071022,D269
2495,DELLO,BS,5578,2816,2762,1030150610,017066,D270
2496,DEMONTE,CN,1853,954,899,1010270790,004079,D271
2497,DENICE,AL,171,83,88,1010020630,006065,D272
2498,DENNO,TN,1212,621,591,1040830700,022074,D273
2499,DERNICE,AL,180,88,92,1010020640,006066,D277
2500,DEROVERE,CR,286,150,136,1030260390,019040,D278
2501,DERUTA,PG,9444,4635,4809,2100580170,054017,D279
2502,DERVIO,LC,2586,1276,1310,1030980300,097030,D280
2503,DESANA,VC,1063,510,553,1010880540,002054,D281
2504,DESENZANO DEL GARDA,BS,29093,13804,15289,1030150620,017067,D284
2505,DESIO,MB,41668,20470,21198,1031040230,108023,D286
2506,DESULO,NU,2149,1066,1083,4200530150,091016,D287
2507,DIAMANTE,CS,5084,2456,2628,3180250490,078048,D289
2508,DIANO ARENTINO,IM,685,342,343,1070370230,008025,D293
2509,DIANO CASTELLO,IM,2260,1100,1160,1070370240,008026,D296
2510,DIANO D'ALBA,CN,3622,1817,1805,1010270800,004080,D291
2511,DIANO MARINA,IM,5628,2623,3005,1070370250,008027,D297
2512,DIANO SAN PIETRO,IM,1098,544,554,1070370260,008028,D298
2513,DICOMANO,FI,5443,2784,2659,2090300130,048013,D299
2514,DIGNANO,UD,2262,1096,1166,1060850320,030032,D300
2515,DIMARO FOLGARIDA,TN,2081,1003,1078,1040830715,022233,M366
2516,DINAMI,VV,1828,900,928,3181030080,102008,D303
2517,DIPIGNANO,CS,4122,2016,2106,3180250500,078049,D304
2518,DISO,LE,2852,1354,1498,3160410260,075027,D305
2519,DIVIGNANO,NO,1433,708,725,1010520580,003060,D309
2520,DIZZASCO,CO,636,313,323,1030240820,013087,D310
2521,DOBBIACO/TOBLACH,BZ,3355,1699,1656,1040140250,021028,D311
2522,DOBERDO' DEL LAGO,GO,1350,648,702,1060350030,031003,D312
2523,DOGLIANI,CN,4553,2278,2275,1010270810,004081,D314
2524,DOGLIOLA,CH,311,163,148,3130230290,069029,D315
2525,DOGNA,UD,154,81,73,1060850330,030033,D316
2526,DOLCE',VR,2502,1234,1268,1050890310,023031,D317
2527,DOLCEACQUA,IM,2145,1036,1109,1070370270,008029,D318
2528,DOLCEDO,IM,1273,637,636,1070370280,008030,D319
2529,DOLEGNA DEL COLLIO,GO,317,168,149,1060350040,031004,D321
2530,DOLIANOVA,SU,9496,4761,4735,4201110140,111014,D323
2531,DOLO,VE,14941,7279,7662,1050870120,027012,D325
2532,DOLZAGO,LC,2518,1248,1270,1030980310,097031,D327
2533,DOMANICO,CS,904,442,462,3180250510,078050,D328
2534,DOMASO,CO,1451,719,732,1030240840,013089,D329
2535,DOMEGGE DI CADORE,BL,2258,1080,1178,1050100180,025018,D330
2536,DOMICELLA,AV,1838,937,901,3150080310,064031,D331
2537,DOMODOSSOLA,VB,17684,8385,9299,1011020280,103028,D332
2538,DOMUS DE MARIA,SU,1628,832,796,4201110150,111015,D333
2539,DOMUSNOVAS,SU,5922,2914,3008,4201110160,111016,D334
2540,DONATO,BI,710,356,354,1010960240,096024,D339
2541,DONGO,CO,3233,1569,1664,1030240850,013090,D341
2542,DONNAS,AO,2389,1164,1225,1020040230,007023,D338
2543,DONORI,SU,1976,1004,972,4201110170,111017,D344
2544,DORGALI,NU,8368,4211,4157,4200530160,091017,D345
2545,DORIO,LC,321,152,169,1030980320,097032,D346
2546,DORMELLETTO,NO,2561,1236,1325,1010520600,003062,D347
2547,DORNO,PV,4528,2254,2274,1030570580,018061,D348
2548,DORZANO,BI,528,270,258,1010960250,096025,D350
2549,DOSOLO,MN,3263,1627,1636,1030450220,020022,D351
2550,DOSSENA,BG,882,460,422,1030120890,016092,D352
2551,DOSSO DEL LIRO,CO,236,114,122,1030240870,013092,D355
2552,DOUES,AO,502,246,256,1020040240,007024,D356
2553,DOVADOLA,FC,1563,744,819,1080320100,040011,D357
2554,DOVERA,CR,3762,1873,1889,1030260400,019041,D358
2555,DOZZA,BO,6533,3206,3327,1080130250,037025,D360
2556,DRAGONI,CE,1987,936,1051,3150200330,061033,D361
2557,DRAPIA,VV,2062,1007,1055,3181030090,102009,D364
2558,DRENA,TN,587,297,290,1040830730,022078,D365
2559,DRENCHIA,UD,99,48,51,1060850340,030034,D366
2560,DRESANO,MI,3035,1497,1538,1030491000,015101,D367
2561,DRO,TN,5030,2490,2540,1040830740,022079,D371
2562,DRONERO,CN,6902,3404,3498,1010270820,004082,D372
2563,DRUENTO,TO,8973,4379,4594,1010810970,001099,D373
2564,DRUOGNO,VB,1050,522,528,1011020290,103029,D374
2565,DUALCHI,NU,576,284,292,4200530170,091018,D376
2566,DUBINO,SO,3752,1881,1871,1030770270,014027,D377
2567,DUE CARRARE,PD,8963,4484,4479,1050540361,028106,M300
2568,DUEVILLE,VI,13714,6703,7011,1050900380,024038,D379
2569,DUGENTA,BN,2634,1262,1372,3150110261,062027,D380
2570,DUINO AURISINA,TS,8353,4031,4322,1060920010,032001,D383
2571,DUMENZA,VA,1461,746,715,1030860550,012065,D384
2572,DUNO,VA,144,85,59,1030860551,012066,D385
2573,DURAZZANO,BN,2132,1066,1066,3150110270,062028,D386
2574,DURONIA,CB,397,209,188,3140190220,070022,C772
2575,DUSINO SAN MICHELE,AT,1088,560,528,1010070520,005052,D388
2576,EBOLI,SA,37594,19052,18542,3150720500,065050,D390
2577,EDOLO,BS,4411,2164,2247,1030150630,017068,D391
2578,EGNA/NEUMARKT,BZ,5433,2658,2775,1040140260,021029,D392
2579,ELICE,PE,1639,819,820,3130600180,068018,D394
2580,ELINI,NU,559,279,280,4200530171,091019,D395
2581,ELLO,LC,1207,573,634,1030980330,097033,D398
2582,ELMAS,CA,9424,4667,4757,4200170201,092108,D399
2583,ELVA,CN,82,44,38,1010270830,004083,D401
2584,EMARESE,AO,220,110,110,1020040250,007025,D402
2585,EMPOLI,FI,48397,23416,24981,2090300140,048014,D403
2586,ENDINE GAIANO,BG,3379,1693,1686,1030120900,016093,D406
2587,ENEGO,VI,1554,793,761,1050900390,024039,D407
2588,ENEMONZO,UD,1280,632,648,1060850350,030035,D408
2589,ENNA,EN,25815,12298,13517,4190280090,086009,C342
2590,ENTRACQUE,CN,770,395,375,1010270840,004084,D410
2591,ENTRATICO,BG,1992,1007,985,1030120910,016094,D411
2592,ENVIE,CN,1954,993,961,1010270850,004085,D412
2593,EPISCOPIA,PZ,1280,631,649,3170640300,076030,D414
2594,ERACLEA,VE,12006,5965,6041,1050870130,027013,D415
2595,ERBA,CO,16091,7780,8311,1030240890,013095,D416
2596,ERBE',VR,1886,935,951,1050890320,023032,D419
2597,ERBEZZO,VR,797,431,366,1050890330,023033,D420
2598,ERBUSCO,BS,8668,4400,4268,1030150640,017069,D421
2599,ERCHIE,BR,8286,4034,4252,3160160060,074006,D422
2600,ERCOLANO,,50580,24612,25968,3150510301,063064,H243
2601,ERICE,TP,26435,12753,13682,4190820090,081008,D423
2602,ERLI,SV,215,114,101,1070740280,009028,D424
2603,ERTO E CASSO,PN,373,185,188,1060930190,093019,D426
2604,ERULA,SS,691,349,342,4200730271,090088,M292
2605,ERVE,LC,686,339,347,1030980340,097034,D428
2606,ESANATOGLIA,MC,1916,901,1015,2110440160,043016,D429
2607,ESCALAPLANO,SU,2092,1109,983,4201110180,111018,D430
2608,ESCOLCA,SU,543,258,285,4201110190,111019,D431
2609,ESINE,BS,5118,2545,2573,1030150650,017070,D434
2610,ESINO LARIO,LC,762,378,384,1030980350,097035,D436
2611,ESPERIA,FR,3577,1788,1789,2120330310,060031,D440
2612,ESPORLATU,SS,382,184,198,4200730280,090028,D441
2613,ESTE,PD,15975,7651,8324,1050540370,028037,D442
2614,ESTERZILI,SU,565,272,293,4201110200,111020,D443
2615,ETROUBLES,AO,472,251,221,1020040260,007026,D444
2616,EUPILIO,CO,2575,1272,1303,1030240910,013097,D445
2617,EXILLES,TO,241,124,117,1010810980,001100,D433
2618,FABBRICA CURONE,AL,586,285,301,1010020650,006067,D447
2619,FABBRICHE DI VERGEMOLI,LU,715,358,357,2090430125,046036,M319
2620,FABBRICO,RE,6610,3318,3292,1080680210,035021,D450
2621,FABRIANO,AN,29070,14044,15026,2110030170,042017,D451
2622,FABRICA DI ROMA,VT,8133,4029,4104,2120910230,056024,D452
2623,FABRIZIA,VV,2003,964,1039,3181030100,102010,D453
2624,FABRO,TR,2626,1284,1342,2100800110,055011,D454
2625,FAEDIS,UD,2775,1386,1389,1060850360,030036,D455
2626,FAEDO VALTELLINO,SO,503,259,244,1030770280,014028,D456
2627,FAENZA,RA,58899,28946,29953,1080660100,039010,D458
2628,FAETO,FG,606,305,301,3160310220,071023,D459
2629,FAGAGNA,UD,6010,2961,3049,1060850370,030037,D461
2630,FAGGETO LARIO,CO,1148,583,565,1030240920,013098,D462
2631,FAGGIANO,TA,3423,1677,1746,3160780050,073005,D463
2632,FAGNANO ALTO,AQ,375,188,187,3130380420,066042,D465
2633,FAGNANO CASTELLO,CS,3473,1694,1779,3180250520,078051,D464
2634,FAGNANO OLONA,VA,12433,6141,6292,1030860560,012067,D467
2635,FAI DELLA PAGANELLA,TN,905,443,462,1040830760,022081,D468
2636,FAICCHIO,BN,3370,1669,1701,3150110280,062029,D469
2637,FALCADE,BL,1824,877,947,1050100190,025019,D470
2638,FALCIANO DEL MASSICO,CE,3362,1610,1752,3150200331,061101,D471
2639,FALCONARA ALBANESE,CS,1427,701,726,3180250530,078052,D473
2640,FALCONARA MARITTIMA,AN,25576,12371,13205,2110030180,042018,D472
2641,FALCONE,ME,2785,1349,1436,4190480190,083019,D474
2642,FALERIA,VT,1997,992,1005,2120910240,056025,D475
2643,FALERNA,CZ,3759,1901,1858,3180220450,079047,D476
2644,FALERONE,FM,3142,1591,1551,2111050050,109005,D477
2645,FALLO,CH,124,65,59,3130230291,069104,D480
2646,FALOPPIO,CO,4831,2394,2437,1030240930,013099,D482
2647,FALVATERRA,FR,516,258,258,2120330320,060032,D483
2648,FALZES/PFALZEN,BZ,2977,1493,1484,1040140270,021030,D484
2649,FANANO,MO,2941,1441,1500,1080500110,036011,D486
2650,FANNA,PN,1480,729,751,1060930200,093020,D487
2651,FANO,PU,59926,28814,31112,2110590130,041013,D488
2652,FANO ADRIANO,TE,257,142,115,3130790230,067024,D489
2653,FARA FILIORUM PETRI,CH,1971,981,990,3130230300,069030,D494
2654,FARA GERA D'ADDA,BG,7977,3962,4015,1030120930,016096,D490
2655,FARA IN SABINA,RI,13848,6848,7000,2120690250,057027,D493
2656,FARA NOVARESE,NO,2007,986,1021,1010520630,003065,D492
2657,FARA OLIVANA CON SOLA,BG,1312,684,628,1030120940,016097,D491
2658,FARA SAN MARTINO,CH,1294,644,650,3130230310,069031,D495
2659,FARA VICENTINO,VI,3721,1849,1872,1050900400,024040,D496
2660,FARDELLA,PZ,575,292,283,3170640310,076031,D497
2661,FARIGLIANO,CN,1698,838,860,1010270860,004086,D499
2662,FARINDOLA,PE,1357,663,694,3130600190,068019,D501
2663,FARINI,PC,1078,536,542,1080610190,033019,D502
2664,FARNESE,VT,1382,670,712,2120910250,056026,D503
2665,FARRA D'ISONZO,GO,1671,822,849,1060350050,031005,D504
2666,FARRA DI SOLIGO,TV,8508,4189,4319,1050840260,026026,D505
2667,FASANO,BR,38943,19011,19932,3160160070,074007,D508
2668,FASCIA,GE,73,37,36,1070340220,010022,D509
2669,FAUGLIA,PI,3674,1829,1845,2090620140,050014,D510
2670,FAULE,CN,464,227,237,1010270870,004087,D511
2671,FAVALE DI MALVARO,GE,433,217,216,1070340230,010023,D512
2672,FAVARA,AG,31913,15476,16437,4190010170,084017,D514
2673,FAVIGNANA,TP,4468,2281,2187,4190820100,081009,D518
2674,FAVRIA,TO,5115,2552,2563,1010810990,001101,D520
2675,FEISOGLIO,CN,295,142,153,1010270880,004088,D523
2676,FELETTO,TO,2190,1088,1102,1010811000,001102,D524
2677,FELINO,PR,9150,4530,4620,1080560130,034013,D526
2678,FELITTO,SA,1163,549,614,3150720510,065051,D527
2679,FELIZZANO,AL,2131,1052,1079,1010020660,006068,D528
2680,FELTRE,BL,20451,9860,10591,1050100210,025021,D530
2681,FENEGRO',CO,3230,1636,1594,1030240940,013100,D531
2682,FENESTRELLE,TO,481,248,233,1010811010,001103,D532
2683,FERENTILLO,TR,1822,901,921,2100800120,055012,D538
2684,FERENTINO,FR,20162,10088,10074,2120330330,060033,D539
2685,FERLA,SR,2325,1137,1188,4190760080,089008,D540
2686,FERMIGNANO,PU,8239,4089,4150,2110590140,041014,D541
2687,FERMO,FM,35923,17394,18529,2111050060,109006,D542
2688,FERNO,VA,6685,3313,3372,1030860570,012068,D543
2689,FEROLETO ANTICO,CZ,1990,979,1011,3180220460,079048,D544
2690,FEROLETO DELLA CHIESA,RC,1520,745,775,3180670320,080032,D545
2691,FERRANDINA,MT,8089,4017,4072,3170470080,077008,D547
2692,FERRARA,FE,129872,61762,68110,1080290080,038008,D548
2693,FERRARA DI MONTE BALDO,VR,259,134,125,1050890340,023034,D549
2694,FERRAZZANO,CB,3197,1575,1622,3140190230,070023,D550
2695,FERRERA DI VARESE,VA,700,354,346,1030860580,012069,D551
2696,FERRERA ERBOGNONE,PV,1065,547,518,1030570590,018062,D552
2697,FERRERE,AT,1499,753,746,1010070530,005053,D554
2698,FERRIERE,PC,1116,602,514,1080610200,033020,D555
2699,FERRUZZANO,RC,776,362,414,3180670330,080033,D557
2700,FIAMIGNANO,RI,1205,636,569,2120690260,057028,D560
2701,FIANO,TO,2679,1331,1348,1010811020,001104,D562
2702,FIANO ROMANO,RM,16027,8095,7932,2120700360,058036,D561
2703,FIASTRA,MC,621,322,299,2110440170,043017,D564
2704,FIAVE',TN,1068,511,557,1040830780,022083,D565
2705,FICARAZZI,PA,12899,6334,6565,4190550330,082035,D567
2706,FICAROLO,RO,2190,1076,1114,1050710210,029021,D568
2707,FICARRA,ME,1316,632,684,4190480200,083020,D569
2708,FICULLE,TR,1584,784,800,2100800130,055013,D570
2709,FIDENZA,PR,26981,13134,13847,1080560140,034014,B034
2710,FIE' ALLO SCILIAR/VOLS AM SCHLERN,BZ,3627,1796,1831,1040140280,021031,D571
2711,FIEROZZO,TN,470,252,218,1040830800,022085,D573
2712,FIESCO,CR,1200,589,611,1030260420,019043,D574
2713,FIESOLE,FI,13727,6618,7109,2090300150,048015,D575
2714,FIESSE,BS,2003,1003,1000,1030150660,017071,D576
2715,FIESSO D'ARTICO,VE,8422,4159,4263,1050870140,027014,D578
2716,FIESSO UMBERTIANO,RO,3869,1896,1973,1050710220,029022,D577
2717,FIGINO SERENZA,CO,4968,2434,2534,1030240950,013101,D579
2718,FIGLINE E INCISA VALDARNO,FI,23219,11238,11981,2090300155,048052,M321
2719,FIGLINE VEGLIATURO,CS,1113,546,567,3180250540,078053,D582
2720,FILACCIANO,RM,472,232,240,2120700370,058037,D586
2721,FILADELFIA,VV,4948,2422,2526,3181030110,102011,D587
2722,FILAGO,BG,3108,1546,1562,1030120941,016098,D588
2723,FILANDARI,VV,1771,867,904,3181030120,102012,D589
2724,FILATTIERA,MS,2210,1085,1125,2090460060,045006,D590
2725,FILETTINO,FR,517,269,248,2120330340,060034,D591
2726,FILETTO,CH,878,435,443,3130230320,069032,D592
2727,FILIANO,PZ,2768,1369,1399,3170640311,076032,D593
2728,FILIGHERA,PV,815,399,416,1030570600,018063,D594
2729,FILIGNANO,IS,586,299,287,3140940190,094019,D595
2730,FILOGASO,VV,1337,680,657,3181030130,102013,D596
2731,FILOTTRANO,AN,8986,4447,4539,2110030190,042019,D597
2732,FINALE EMILIA,MO,14978,7400,7578,1080500120,036012,D599
2733,FINALE LIGURE,SV,11157,5322,5835,1070740290,009029,D600
2734,FINO DEL MONTE,BG,1155,595,560,1030120950,016099,D604
2735,FINO MORNASCO,CO,9829,4904,4925,1030240960,013102,D605
2736,FIORANO AL SERIO,BG,2961,1432,1529,1030120960,016100,D606
2737,FIORANO CANAVESE,TO,735,363,372,1010811030,001105,D608
2738,FIORANO MODENESE,MO,16870,8361,8509,1080500130,036013,D607
2739,FIORENZUOLA D'ARDA,PC,14858,7284,7574,1080610210,033021,D611
2740,FIRENZE,FI,361619,170671,190948,2090300170,048017,D612
2741,FIRENZUOLA,FI,4436,2204,2232,2090300180,048018,D613
2742,FIRMO,CS,1880,938,942,3180250550,078054,D614
2743,FISCAGLIA,FE,8385,4120,4265,1080290085,038027,M323
2744,FISCIANO,SA,13859,6885,6974,3150720520,065052,D615
2745,FIUGGI,FR,10120,4909,5211,2120330350,060035,A310
2746,FIUMALBO,MO,1180,594,586,1080500140,036014,D617
2747,FIUMARA,RC,849,411,438,3180670340,080034,D619
2748,FIUME VENETO,PN,11739,5737,6002,1060930210,093021,D621
2749,FIUMEDINISI,ME,1288,642,646,4190480210,083021,D622
2750,FIUMEFREDDO BRUZIO,CS,2799,1388,1411,3180250560,078055,D624
2751,FIUMEFREDDO DI SICILIA,CT,9128,4335,4793,4190210160,087016,D623
2752,FIUMICELLO VILLA VICENTINA,UD,6299,3102,3197,1060850385,030190,M400
2753,FIUMICINO,RM,80738,40292,40446,2120700371,058120,M297
2754,FIUMINATA,MC,1275,627,648,2110440190,043019,D628
2755,FIVIZZANO,MS,7190,3524,3666,2090460070,045007,D629
2756,FLAIBANO,UD,1095,555,540,1060850390,030039,D630
2757,FLERO,BS,8808,4382,4426,1030150661,017072,D634
2758,FLORESTA,ME,470,233,237,4190480220,083022,D635
2759,FLORIDIA,SR,21471,10550,10921,4190760090,089009,D636
2760,FLORINAS,SS,1446,715,731,4200730290,090029,D637
2761,FLUMERI,AV,2527,1220,1307,3150080320,064032,D638
2762,FLUMINIMAGGIORE,SU,2681,1325,1356,4201110210,111021,D639
2763,FLUSSIO,OR,426,191,235,4200950196,095080,D640
2764,FOBELLO,VC,186,108,78,1010880570,002057,D641
2765,FOGGIA,FG,146803,72103,74700,3160310230,071024,D643
2766,FOGLIANISE,BN,3184,1543,1641,3150110290,062030,D644
2767,FOGLIANO REDIPUGLIA,GO,2992,1436,1556,1060350060,031006,D645
2768,FOGLIZZO,TO,2265,1099,1166,1010811040,001106,D646
2769,FOIANO DELLA CHIANA,AR,9183,4482,4701,2090050180,051018,D649
2770,FOIANO DI VAL FORTORE,BN,1336,647,689,3150110300,062031,D650
2771,FOLGARIA,TN,3147,1526,1621,1040830820,022087,D651
2772,FOLIGNANO,AP,8872,4392,4480,2110060200,044020,D652
2773,FOLIGNO,PG,55503,26494,29009,2100580180,054018,D653
2774,FOLLINA,TV,3634,1756,1878,1050840270,026027,D654
2775,FOLLO,SP,6133,3054,3079,1070390130,011013,D655
2776,FOLLONICA,GR,20607,9716,10891,2090360080,053009,D656
2777,FOMBIO,LO,2239,1154,1085,1030990260,098026,D660
2778,FONDACHELLI-FANTINA,ME,943,519,424,4190480230,083023,D661
2779,FONDI,LT,39507,19748,19759,2120400070,059007,D662
2780,FONNI,NU,3692,1786,1906,4200530220,091024,D665
2781,FONTAINEMORE,AO,425,221,204,1020040280,007028,D666
2782,FONTANA LIRI,FR,2752,1350,1402,2120330360,060036,D667
2783,FONTANAFREDDA,PN,12762,6334,6428,1060930220,093022,D670
2784,FONTANAROSA,AV,2886,1414,1472,3150080330,064033,D671
2785,FONTANELICE,BO,1931,976,955,1080130260,037026,D668
2786,FONTANELLA,BG,4722,2388,2334,1030120970,016101,D672
2787,FONTANELLATO,PR,7005,3489,3516,1080560150,034015,D673
2788,FONTANELLE,TV,5657,2810,2847,1050840280,026028,D674
2789,FONTANETO D'AGOGNA,NO,2592,1283,1309,1010520640,003066,D675
2790,FONTANETTO PO,VC,1053,526,527,1010880580,002058,D676
2791,FONTANIGORDA,GE,244,129,115,1070340240,010024,D677
2792,FONTANILE,AT,493,241,252,1010070540,005054,D678
2793,FONTANIVA,PD,7965,3983,3982,1050540380,028038,D679
2794,FONTE,TV,6066,3082,2984,1050840290,026029,D680
2795,FONTE NUOVA,RM,32491,16028,16463,2120700375,058122,M309
2796,FONTECCHIO,AQ,289,136,153,3130380430,066043,D681
2797,FONTECHIARI,FR,1256,589,667,2120330370,060037,D682
2798,FONTEGRECA,CE,760,386,374,3150200340,061034,D683
2799,FONTENO,BG,567,287,280,1030120980,016102,D684
2800,FONTEVIVO,PR,5577,2806,2771,1080560160,034016,D685
2801,FONZASO,BL,3053,1522,1531,1050100220,025022,D686
2802,FOPPOLO,BG,168,98,70,1030120990,016103,D688
2803,FORANO,RI,3078,1554,1524,2120690270,057029,D689
2804,FORCE,AP,1159,585,574,2110060210,044021,D691
2805,FORCHIA,BN,1200,610,590,3150110310,062032,D693
2806,FORCOLA,SO,765,383,382,1030770290,014029,D694
2807,FORDONGIANUS,OR,850,410,440,4200950200,095020,D695
2808,FORENZA,PZ,1875,950,925,3170640320,076033,D696
2809,FORESTO SPARSO,BG,3053,1559,1494,1030121000,016104,D697
2810,FORGARIA NEL FRIULI,UD,1708,861,847,1060850391,030137,D700
2811,FORINO,AV,5177,2583,2594,3150080340,064034,D701
2812,FORIO,,17456,8716,8740,3150510310,063031,D702
2813,FORLI',FC,116558,56620,59938,1080320110,040012,D704
2814,FORLI' DEL SANNIO,IS,633,313,320,3140940200,094020,D703
2815,FORLIMPOPOLI,FC,13113,6427,6686,1080320120,040013,D705
2816,FORMAZZA,VB,442,227,215,1011020310,103031,D706
2817,FORMELLO,RM,13481,6516,6965,2120700380,058038,D707
2818,FORMIA,LT,37278,17922,19356,2120400080,059008,D708
2819,FORMICOLA,CE,1405,682,723,3150200350,061035,D709
2820,FORMIGARA,CR,1001,494,507,1030260430,019044,D710
2821,FORMIGINE,MO,34494,17059,17435,1080500150,036015,D711
2822,FORMIGLIANA,VC,497,252,245,1010880590,002059,D712
2823,FORNACE,TN,1313,673,640,1040830840,022089,D714
2824,FORNELLI,IS,1791,892,899,3140940210,094021,D715
2825,FORNI AVOLTRI,UD,515,256,259,1060850400,030040,D718
2826,FORNI DI SOPRA,UD,923,468,455,1060850410,030041,D719
2827,FORNI DI SOTTO,UD,548,278,270,1060850420,030042,D720
2828,FORNO CANAVESE,TO,3230,1622,1608,1010811050,001107,D725
2829,FORNOVO DI TARO,PR,5863,2861,3002,1080560170,034017,D728
2830,FORNOVO SAN GIOVANNI,BG,3386,1690,1696,1030121010,016105,D727
2831,FORTE DEI MARMI,LU,6943,3205,3738,2090430130,046013,D730
2832,FORTEZZA/FRANZENSFESTE,BZ,1061,543,518,1040140290,021032,D731
2833,FORTUNAGO,PV,348,184,164,1030570610,018064,D732
2834,FORZA D'AGRO',ME,848,419,429,4190480240,083024,D733
2835,FOSCIANDORA,LU,559,269,290,2090430140,046014,D734
2836,FOSDINOVO,MS,4597,2258,2339,2090460080,045008,D735
2837,FOSSA,AQ,698,344,354,3130380440,066044,D736
2838,FOSSACESIA,CH,6244,3085,3159,3130230330,069033,D738
2839,FOSSALTA DI PIAVE,VE,4147,2035,2112,1050870150,027015,D740
2840,FOSSALTA DI PORTOGRUARO,VE,5792,2808,2984,1050870160,027016,D741
2841,FOSSALTO,CB,1178,568,610,3140190240,070024,D737
2842,FOSSANO,CN,24242,12136,12106,1010270890,004089,D742
2843,FOSSATO DI VICO,PG,2652,1316,1336,2100580190,054019,D745
2844,FOSSATO SERRALTA,CZ,574,281,293,3180220500,079052,D744
2845,FOSSO',VE,7051,3457,3594,1050870170,027017,D748
2846,FOSSOMBRONE,PU,9096,4516,4580,2110590150,041015,D749
2847,FOZA,VI,661,347,314,1050900410,024041,D750
2848,FRABOSA SOPRANA,CN,719,380,339,1010270900,004090,D751
2849,FRABOSA SOTTANA,CN,1604,868,736,1010270910,004091,D752
2850,FRACONALTO,AL,303,163,140,1010020670,006069,D559
2851,FRAGAGNANO,TA,4999,2397,2602,3160780060,073006,D754
2852,FRAGNETO L'ABATE,BN,983,468,515,3150110320,062033,D755
2853,FRAGNETO MONFORTE,BN,1689,820,869,3150110330,062034,D756
2854,FRAINE,CH,274,127,147,3130230340,069034,D757
2855,FRAMURA,SP,599,303,296,1070390140,011014,D758
2856,FRANCAVILLA AL MARE,CH,25723,12274,13449,3130230350,069035,D763
2857,FRANCAVILLA ANGITOLA,VV,1807,901,906,3181030140,102014,D762
2858,FRANCAVILLA BISIO,AL,506,255,251,1010020680,006070,D759
2859,FRANCAVILLA D'ETE,FM,936,481,455,2111050070,109007,D760
2860,FRANCAVILLA DI SICILIA,ME,3591,1715,1876,4190480250,083025,D765
2861,FRANCAVILLA FONTANA,BR,35246,17091,18155,3160160080,074008,D761
2862,FRANCAVILLA IN SINNI,PZ,3985,1977,2008,3170640330,076034,D766
2863,FRANCAVILLA MARITTIMA,CS,2778,1360,1418,3180250570,078056,D764
2864,FRANCICA,VV,1578,800,778,3181030150,102015,D767
2865,FRANCOFONTE,SR,11888,5821,6067,4190760100,089010,D768
2866,FRANCOLISE,CE,4623,2314,2309,3150200360,061036,D769
2867,FRASCARO,AL,449,214,235,1010020690,006071,D770
2868,FRASCAROLO,PV,1088,526,562,1030570620,018065,D771
2869,FRASCATI,RM,22705,10845,11860,2120700390,058039,D773
2870,FRASCINETO,CS,1927,916,1011,3180250580,078057,D774
2871,FRASSILONGO,TN,338,173,165,1040830850,022090,D775
2872,FRASSINELLE POLESINE,RO,1344,673,671,1050710230,029023,D776
2873,FRASSINELLO MONFERRATO,AL,470,225,245,1010020700,006072,D777
2874,FRASSINETO PO,AL,1362,666,696,1010020710,006073,D780
2875,FRASSINETTO,TO,279,160,119,1010811060,001108,D781
2876,FRASSINO,CN,262,142,120,1010270920,004092,D782
2877,FRASSINORO,MO,1754,877,877,1080500160,036016,D783
2878,FRASSO SABINO,RI,736,369,367,2120690280,057030,D785
2879,FRASSO TELESINO,BN,2047,1011,1036,3150110340,062035,D784
2880,FRATTA POLESINE,RO,2501,1172,1329,1050710240,029024,D788
2881,FRATTA TODINA,PG,1845,904,941,2100580200,054020,D787
2882,FRATTAMAGGIORE,,28721,13896,14825,3150510320,063032,D789
2883,FRATTAMINORE,,15580,7690,7890,3150510330,063033,D790
2884,FRATTE ROSA,PU,859,422,437,2110590160,041016,D791
2885,FRAZZANO',ME,594,295,299,4190480260,083026,D793
2886,FREGONA,TV,2815,1393,1422,1050840300,026030,D794
2887,FRESAGRANDINARIA,CH,899,437,462,3130230360,069036,D796
2888,FRESONARA,AL,623,324,299,1010020720,006074,D797
2889,FRIGENTO,AV,3461,1734,1727,3150080350,064035,D798
2890,FRIGNANO,CE,9010,4464,4546,3150200370,061037,D799
2891,FRINCO,AT,762,380,382,1010070550,005055,D802
2892,FRISA,CH,1626,813,813,3130230370,069037,D803
2893,FRISANCO,PN,559,285,274,1060930240,093024,D804
2894,FRONT,TO,1613,816,797,1010811070,001109,D805
2895,FRONTINO,PU,285,141,144,2110590170,041017,D807
2896,FRONTONE,PU,1204,587,617,2110590180,041018,D808
2897,FROSINONE,FR,43830,20931,22899,2120330380,060038,D810
2898,FROSOLONE,IS,2889,1474,1415,3140940220,094022,D811
2899,FROSSASCO,TO,2799,1376,1423,1010811080,001110,D812
2900,FRUGAROLO,AL,1893,909,984,1010020730,006075,D813
2901,FUBINE MONFERRATO,AL,1577,765,812,1010020740,006076,D814
2902,FUCECCHIO,FI,22764,11206,11558,2090300190,048019,D815
2903,FUIPIANO VALLE IMAGNA,BG,208,103,105,1030121020,016106,D817
2904,FUMANE,VR,4106,2123,1983,1050890350,023035,D818
2905,FUMONE,FR,1997,980,1017,2120330390,060039,D819
2906,FUNES/VILLNOSS,BZ,2545,1273,1272,1040140300,021033,D821
2907,FURCI,CH,820,384,436,3130230380,069038,D823
2908,FURCI SICULO,ME,3221,1566,1655,4190480270,083027,D824
2909,FURNARI,ME,3851,1916,1935,4190480280,083028,D825
2910,FURORE,SA,700,372,328,3150720530,065053,D826
2911,FURTEI,SU,1525,768,757,4201110220,111022,D827
2912,FUSCALDO,CS,7827,3913,3914,3180250590,078058,D828
2913,FUSIGNANO,RA,8075,3996,4079,1080660110,039011,D829
2914,FUSINE,SO,553,278,275,1030770300,014030,D830
2915,FUTANI,SA,1100,502,598,3150720540,065054,D832
2916,FENIS,AO,1788,872,916,1020040270,007027,D537
2917,GABBIONETA BINANUOVA,CR,859,430,429,1030260440,019045,D834
2918,GABIANO,AL,1022,525,497,1010020750,006077,D835
2919,GABICCE MARE,PU,5540,2703,2837,2110590190,041019,D836
2920,GABY,AO,424,219,205,1020040281,007029,D839
2921,GADESCO PIEVE DELMONA,CR,1889,946,943,1030260450,019046,D841
2922,GADONI,NU,703,338,365,4200530230,091025,D842
2923,GAETA,LT,19598,9423,10175,2120400090,059009,D843
2924,GAGGI,ME,3116,1530,1586,4190480290,083029,D844
2925,GAGGIANO,MI,9218,4493,4725,1030491020,015103,D845
2926,GAGGIO MONTANO,BO,4797,2370,2427,1080130270,037027,D847
2927,GAGLIANICO,BI,3741,1740,2001,1010960260,096026,D848
2928,GAGLIANO ATERNO,AQ,236,118,118,3130380450,066045,D850
2929,GAGLIANO CASTELFERRATO,EN,3344,1592,1752,4190280100,086010,D849
2930,GAGLIANO DEL CAPO,LE,4894,2370,2524,3160410270,075028,D851
2931,GAGLIATO,CZ,440,211,229,3180220530,079055,D852
2932,GAGLIOLE,MC,523,272,251,2110440200,043020,D853
2933,GAIARINE,TV,6025,3006,3019,1050840310,026031,D854
2934,GAIBA,RO,970,470,500,1050710250,029025,D855
2935,GAIOLA,CN,574,298,276,1010270930,004093,D856
2936,GAIOLE IN CHIANTI,SI,2584,1295,1289,2090750130,052013,D858
2937,GAIRO,NU,1304,652,652,4200530240,091026,D859
2938,GAIS/GAIS,BZ,3230,1667,1563,1040140310,021034,D860
2939,GALATI MAMERTINO,ME,2328,1067,1261,4190480300,083030,D861
2940,GALATINA,LE,25885,12438,13447,3160410280,075029,D862
2941,GALATONE,LE,15095,7266,7829,3160410290,075030,D863
2942,GALATRO,RC,1453,697,756,3180670350,080035,D864
2943,GALBIATE,LC,8458,4138,4320,1030980360,097036,D865
2944,GALEATA,FC,2438,1222,1216,1080320130,040014,D867
2945,GALGAGNANO,LO,1310,671,639,1030990270,098027,D868
2946,GALLARATE,VA,52452,25626,26826,1030860590,012070,D869
2947,GALLESE,VT,2623,1270,1353,2120910260,056027,D870
2948,GALLIATE,NO,15551,7587,7964,1010520660,003068,D872
2949,GALLIATE LOMBARDO,VA,989,479,510,1030860600,012071,D871
2950,GALLIAVOLA,PV,171,79,92,1030570630,018066,D873
2951,GALLICANO,LU,3613,1813,1800,2090430150,046015,D874
2952,GALLICANO NEL LAZIO,RM,6500,3283,3217,2120700400,058040,D875
2953,GALLICCHIO,PZ,813,434,379,3170640340,076035,D876
2954,GALLIERA,BO,5529,2765,2764,1080130280,037028,D878
2955,GALLIERA VENETA,PD,7105,3532,3573,1050540390,028039,D879
2956,GALLINARO,FR,1220,590,630,2120330400,060040,D881
2957,GALLIO,VI,2342,1156,1186,1050900420,024042,D882
2958,GALLIPOLI,LE,19561,9493,10068,3160410300,075031,D883
2959,GALLO MATESE,CE,494,245,249,3150200380,061038,D884
2960,GALLODORO,ME,336,160,176,4190480301,083031,D885
2961,GALLUCCIO,CE,2041,1006,1035,3150200390,061039,D886
2962,GALTELLI',NU,2384,1181,1203,4200530250,091027,D888
2963,GALZIGNANO TERME,PD,4301,2134,2167,1050540400,028040,D889
2964,GAMALERO,AL,817,383,434,1010020760,006078,D890
2965,GAMBARA,BS,4549,2296,2253,1030150670,017073,D891
2966,GAMBARANA,PV,200,96,104,1030570640,018067,D892
2967,GAMBASCA,CN,347,182,165,1010270940,004094,D894
2968,GAMBASSI TERME,FI,4791,2346,2445,2090300200,048020,D895
2969,GAMBATESA,CB,1283,625,658,3140190250,070025,D896
2970,GAMBELLARA,VI,3399,1689,1710,1050900430,024043,D897
2971,GAMBERALE,CH,281,139,142,3130230390,069039,D898
2972,GAMBETTOLA,FC,10659,5175,5484,1080320140,040015,D899
2973,GAMBOLO',PV,9697,4788,4909,1030570650,018068,D901
2974,GANDELLINO,BG,965,507,458,1030121021,016107,D903
2975,GANDINO,BG,5174,2553,2621,1030121030,016108,D905
2976,GANDOSSO,BG,1445,744,701,1030121040,016109,D906
2977,GANGI,PA,6179,2960,3219,4190550340,082036,D907
2978,GARAGUSO,MT,994,498,496,3170470090,077009,D909
2979,GARBAGNA,AL,615,301,314,1010020770,006079,D910
2980,GARBAGNA NOVARESE,NO,1405,704,701,1010520670,003069,D911
2981,GARBAGNATE MILANESE,MI,26792,13026,13766,1030491040,015105,D912
2982,GARBAGNATE MONASTERO,LC,2533,1304,1229,1030980370,097037,D913
2983,GARDA,VR,4142,2037,2105,1050890360,023036,D915
2984,GARDONE RIVIERA,BS,2608,1295,1313,1030150680,017074,D917
2985,GARDONE VAL TROMPIA,BS,11352,5653,5699,1030150690,017075,D918
2986,GARESSIO,CN,2881,1399,1482,1010270950,004095,D920
2987,GARGALLO,NO,1764,870,894,1010520680,003070,D921
2988,GARGAZZONE/GARGAZON,BZ,1811,882,929,1040140320,021035,D923
2989,GARGNANO,BS,2731,1311,1420,1030150700,017076,D924
2990,GARLASCO,PV,9456,4592,4864,1030570660,018069,D925
2991,GARLATE,LC,2666,1335,1331,1030980380,097038,D926
2992,GARLENDA,SV,1348,673,675,1070740300,009030,D927
2993,GARNIGA TERME,TN,391,208,183,1040830860,022091,D928
2994,GARZENO,CO,676,338,338,1030241000,013106,D930
2995,GARZIGLIANA,TO,530,264,266,1010811090,001111,D931
2996,GASPERINA,CZ,1908,949,959,3180220540,079056,D932
2997,GASSINO TORINESE,TO,9361,4516,4845,1010811100,001112,D933
2998,GATTATICO,RE,5712,2899,2813,1080680220,035022,D934
2999,GATTEO,FC,9320,4671,4649,1080320150,040016,D935
3000,GATTICO-VERUNO,NO,5224,2542,2682,1010520695,003166,M416
3001,GATTINARA,VC,7611,3694,3917,1010880610,002061,D938
3002,GAVARDO,BS,12198,6188,6010,1030150710,017077,D940
3003,GAVELLO,RO,1451,745,706,1050710260,029026,D942
3004,GAVERINA TERME,BG,868,451,417,1030121050,016110,D943
3005,GAVI,AL,4444,2200,2244,1010020790,006081,D944
3006,GAVIGNANO,RM,1928,973,955,2120700410,058041,D945
3007,GAVIRATE,VA,9136,4367,4769,1030860610,012072,D946
3008,GAVOI,NU,2497,1237,1260,4200530260,091028,D947
3009,GAVORRANO,GR,8192,4061,4131,2090360090,053010,D948
3010,GAZOLDO DEGLI IPPOLITI,MN,3007,1531,1476,1030450240,020024,D949
3011,GAZZADA SCHIANNO,VA,4559,2224,2335,1030860620,012073,D951
3012,GAZZANIGA,BG,4928,2383,2545,1030121060,016111,D952
3013,GAZZO,PD,4291,2150,2141,1050540410,028041,D956
3014,GAZZO VERONESE,VR,5178,2576,2602,1050890370,023037,D957
3015,GAZZOLA,PC,2096,1081,1015,1080610220,033022,D958
3016,GAZZUOLO,MN,2087,1024,1063,1030450250,020025,D959
3017,GELA,CL,71937,35175,36762,4190180070,085007,D960
3018,GEMMANO,RN,1121,561,560,1081010040,099004,D961
3019,GEMONA DEL FRIULI,UD,10544,5080,5464,1060850430,030043,D962
3020,GEMONIO,VA,2847,1416,1431,1030860630,012074,D963
3021,GENAZZANO,RM,5611,2813,2798,2120700420,058042,D964
3022,GENGA,AN,1664,823,841,2110030200,042020,D965
3023,GENIVOLTA,CR,1127,567,560,1030260460,019047,D966
3024,GENOLA,CN,2587,1311,1276,1010270960,004096,D967
3025,GENONI,SU,771,384,387,4201110230,111023,D968
3026,GENOVA,GE,561203,266949,294254,1070340250,010025,D969
3027,GENURI,SU,314,149,165,4201110240,111024,D970
3028,GENZANO DI LUCANIA,PZ,5303,2637,2666,3170640350,076036,D971
3029,GENZANO DI ROMA,RM,23058,11207,11851,2120700430,058043,D972
3030,GERA LARIO,CO,1054,534,520,1030241010,013107,D974
3031,GERACE,RC,2399,1202,1197,3180670360,080036,D975
3032,GERACI SICULO,PA,1720,850,870,4190550350,082037,D977
3033,GERANO,RM,1157,584,573,2120700440,058044,D978
3034,GERENZAGO,PV,1424,716,708,1030570680,018071,D980
3035,GERENZANO,VA,10751,5262,5489,1030860640,012075,D981
3036,GERGEI,SU,1137,582,555,4201110250,111025,D982
3037,GERMAGNANO,TO,1120,572,548,1010811110,001113,D983
3038,GERMAGNO,VB,181,99,82,1011020320,103032,D984
3039,GERMIGNAGA,VA,3743,1818,1925,1030860650,012076,D987
3040,GEROCARNE,VV,1936,976,960,3181030160,102016,D988
3041,GEROLA ALTA,SO,161,98,63,1030770310,014031,D990
3042,GERRE DE' CAPRIOLI,CR,1306,658,648,1030260470,019048,D993
3043,GESICO,SU,771,387,384,4201110260,111026,D994
3044,GESSATE,MI,8791,4368,4423,1030491050,015106,D995
3045,GESSOPALENA,CH,1234,593,641,3130230400,069040,D996
3046,GESTURI,SU,1164,570,594,4201110270,111027,D997
3047,GESUALDO,AV,3274,1618,1656,3150080360,064036,D998
3048,GHEDI,BS,18518,9360,9158,1030150720,017078,D999
3049,GHEMME,NO,3386,1657,1729,1010520700,003073,E001
3050,GHIFFA,VB,2294,1145,1149,1011020330,103033,E003
3051,GHILARZA,OR,4241,2035,2206,4200950210,095021,E004
3052,GHISALBA,BG,6157,3088,3069,1030121080,016113,E006
3053,GHISLARENGO,VC,816,414,402,1010880620,002062,E007
3054,GIACCIANO CON BARUCHELLA,RO,2043,1028,1015,1050710270,029027,E008
3055,GIAGLIONE,TO,592,283,309,1010811120,001114,E009
3056,GIANICO,BS,2121,1038,1083,1030150730,017079,E010
3057,GIANO DELL'UMBRIA,PG,3654,1845,1809,2100580210,054021,E012
3058,GIANO VETUSTO,CE,655,316,339,3150200400,061040,E011
3059,GIARDINELLO,PA,2293,1154,1139,4190550360,082038,E013
3060,GIARDINI NAXOS,ME,9148,4336,4812,4190480310,083032,E014
3061,GIAROLE,AL,671,312,359,1010020800,006082,E015
3062,GIARRATANA,RG,2803,1369,1434,4190650040,088004,E016
3063,GIARRE,CT,26685,12901,13784,4190210170,087017,E017
3064,GIAVE,SS,494,253,241,4200730300,090030,E019
3065,GIAVENO,TO,16214,7942,8272,1010811130,001115,E020
3066,GIAVERA DEL MONTELLO,TV,5165,2596,2569,1050840311,026032,E021
3067,GIBA,SU,1919,930,989,4201110280,111028,E022
3068,GIBELLINA,TP,3801,1791,2010,4190820110,081010,E023
3069,GIFFLENGA,BI,104,55,49,1010960270,096027,E024
3070,GIFFONE,RC,1615,794,821,3180670370,080037,E025
3071,GIFFONI SEI CASALI,SA,4987,2500,2487,3150720550,065055,E026
3072,GIFFONI VALLE PIANA,SA,11602,5729,5873,3150720560,065056,E027
3073,GIGNESE,VB,1055,547,508,1011020340,103034,E028
3074,GIGNOD,AO,1699,849,850,1020040290,007030,E029
3075,GILDONE,CB,755,368,387,3140190260,070026,E030
3076,GIMIGLIANO,CZ,3035,1500,1535,3180220560,079058,E031
3077,GINESTRA,PZ,709,360,349,3170640351,076099,E033
3078,GINESTRA DEGLI SCHIAVONI,BN,417,213,204,3150110350,062036,E034
3079,GINOSA,TA,21869,10909,10960,3160780070,073007,E036
3080,GIOI,SA,1127,530,597,3150720570,065057,E037
3081,GIOIA DEI MARSI,AQ,1705,892,813,3130380460,066046,E040
3082,GIOIA DEL COLLE,BA,26731,13094,13637,3160090210,072021,E038
3083,GIOIA SANNITICA,CE,3357,1661,1696,3150200410,061041,E039
3084,GIOIA TAURO,RC,19254,9578,9676,3180670380,080038,E041
3085,GIOIOSA IONICA,RC,6865,3375,3490,3180670390,080039,E044
3086,GIOIOSA MAREA,ME,6737,3274,3463,4190480320,083033,E043
3087,GIOVE,TR,1846,899,947,2100800140,055014,E045
3088,GIOVINAZZO,BA,19485,9429,10056,3160090220,072022,E047
3089,GIOVO,TN,2520,1287,1233,1040830870,022092,E048
3090,GIRASOLE,NU,1335,660,675,4200530290,091031,E049
3091,GIRIFALCO,CZ,5623,2752,2871,3180220570,079059,E050
3092,GISSI,CH,2517,1228,1289,3130230410,069041,E052
3093,GIUGGIANELLO,LE,1141,555,586,3160410310,075032,E053
3094,GIUGLIANO IN CAMPANIA,,123758,61423,62335,3150510340,063034,E054
3095,GIULIANA,PA,1731,870,861,4190550370,082039,E055
3096,GIULIANO DI ROMA,FR,2348,1168,1180,2120330410,060041,E057
3097,GIULIANO TEATINO,CH,1135,574,561,3130230420,069042,E056
3098,GIULIANOVA,TE,23442,11160,12282,3130790240,067025,E058
3099,GIUNGANO,SA,1300,646,654,3150720580,065058,E060
3100,GIURDIGNANO,LE,1946,968,978,3160410320,075033,E061
3101,GIUSSAGO,PV,5245,2653,2592,1030570690,018072,E062
3102,GIUSSANO,MB,26015,12958,13057,1031040240,108024,E063
3103,GIUSTENICE,SV,993,493,500,1070740310,009031,E064
3104,GIUSTINO,TN,741,357,384,1040830880,022093,E065
3105,GIUSVALLA,SV,401,208,193,1070740320,009032,E066
3106,GIVOLETTO,TO,4095,2067,2028,1010811140,001116,E067
3107,GIZZERIA,CZ,4997,2604,2393,3180220580,079060,E068
3108,GLORENZA/GLURNS,BZ,924,472,452,1040140330,021036,E069
3109,GODEGA DI SANT'URBANO,TV,5942,2940,3002,1050840320,026033,E071
3110,GODIASCO SALICE TERME,PV,3192,1523,1669,1030570700,018073,E072
3111,GODRANO,PA,1063,528,535,4190550380,082040,E074
3112,GOITO,MN,10063,4992,5071,1030450260,020026,E078
3113,GOLASECCA,VA,2654,1318,1336,1030860660,012077,E079
3114,GOLFERENZO,PV,175,96,79,1030570710,018074,E081
3115,GOLFO ARANCI,SS,2376,1145,1231,4200730301,090083,M274
3116,GOMBITO,CR,617,329,288,1030260480,019049,E082
3117,GONARS,UD,4554,2229,2325,1060850440,030044,E083
3118,GONI,SU,455,250,205,4201110290,111029,E084
3119,GONNESA,SU,4697,2335,2362,4201110300,111030,E086
3120,GONNOSCODINA,OR,436,238,198,4200950220,095022,E087
3121,GONNOSFANADIGA,SU,6243,3029,3214,4201110310,111031,E085
3122,GONNOSNO',OR,712,352,360,4200950230,095023,D585
3123,GONNOSTRAMATZA,OR,809,394,415,4200950240,095024,E088
3124,GONZAGA,MN,8663,4384,4279,1030450270,020027,E089
3125,GORDONA,SO,1936,967,969,1030770320,014032,E090
3126,GORGA,RM,689,346,343,2120700450,058045,E091
3127,GORGO AL MONTICANO,TV,4013,2053,1960,1050840330,026034,E092
3128,GORGOGLIONE,MT,870,441,429,3170470100,077010,E093
3129,GORGONZOLA,MI,20949,10169,10780,1030491070,015108,E094
3130,GORIANO SICOLI,AQ,510,265,245,3130380470,066047,E096
3131,GORIZIA,GO,33615,16373,17242,1060350070,031007,E098
3132,GORLA MAGGIORE,VA,4872,2426,2446,1030860670,012078,E101
3133,GORLA MINORE,VA,8094,4046,4048,1030860680,012079,E102
3134,GORLAGO,BG,5119,2556,2563,1030121090,016114,E100
3135,GORLE,BG,6573,3180,3393,1030121100,016115,E103
3136,GORNATE OLONA,VA,2179,1102,1077,1030860690,012080,E104
3137,GORNO,BG,1498,756,742,1030121110,016116,E106
3138,GORO,FE,3533,1694,1839,1080290091,038025,E107
3139,GORRETO,GE,94,48,46,1070340260,010026,E109
3140,GORZEGNO,CN,255,132,123,1010270970,004097,E111
3141,GOSALDO,BL,539,276,263,1050100250,025025,E113
3142,GOSSOLENGO,PC,5711,2835,2876,1080610230,033023,E114
3143,GOTTASECCA,CN,130,65,65,1010270980,004098,E115
3144,GOTTOLENGO,BS,4957,2444,2513,1030150740,017080,E116
3145,GOVONE,CN,2255,1091,1164,1010270990,004099,E118
3146,GOZZANO,NO,5487,2746,2741,1010520730,003076,E120
3147,GRADARA,PU,4919,2487,2432,2110590200,041020,E122
3148,GRADISCA D'ISONZO,GO,6370,3030,3340,1060350080,031008,E124
3149,GRADO,GO,7789,3727,4062,1060350090,031009,E125
3150,GRADOLI,VT,1280,638,642,2120910270,056028,E126
3151,GRAFFIGNANA,LO,2578,1297,1281,1030990280,098028,E127
3152,GRAFFIGNANO,VT,2120,1042,1078,2120910280,056029,E128
3153,GRAGLIA,BI,1466,716,750,1010960280,096028,E130
3154,GRAGNANO,,28167,13819,14348,3150510350,063035,E131
3155,GRAGNANO TREBBIENSE,PC,4538,2252,2286,1080610240,033024,E132
3156,GRAMMICHELE,CT,12566,6129,6437,4190210180,087018,E133
3157,GRANA MONFERRATO,AT,523,246,277,1010070560,005056,E134
3158,GRANAROLO DELL'EMILIA,BO,12578,6189,6389,1080130300,037030,E136
3159,GRANDATE,CO,2814,1355,1459,1030241030,013110,E139
3160,GRANDOLA ED UNITI,CO,1317,663,654,1030241040,013111,E141
3161,GRANITI,ME,1449,735,714,4190480330,083034,E142
3162,GRANOZZO CON MONTICELLO,NO,1332,667,665,1010520740,003077,E143
3163,GRANTOLA,VA,1237,598,639,1030860691,012081,E144
3164,GRANTORTO,PD,4511,2273,2238,1050540420,028042,E145
3165,GRANZE,PD,1948,944,1004,1050540430,028043,E146
3166,GRASSANO,MT,4788,2399,2389,3170470110,077011,E147
3167,GRASSOBBIO,BG,6436,3255,3181,1030121120,016117,E148
3168,GRATTERI,PA,873,437,436,4190550390,082041,E149
3169,GRAVEDONA ED UNITI,CO,4085,1988,2097,1030241055,013249,M315
3170,GRAVELLONA LOMELLINA,PV,2711,1339,1372,1030570720,018075,E152
3171,GRAVELLONA TOCE,VB,7671,3694,3977,1011020350,103035,E153
3172,GRAVERE,TO,666,346,320,1010811150,001117,E154
3173,GRAVINA DI CATANIA,CT,25156,11966,13190,4190210190,087019,E156
3174,GRAVINA IN PUGLIA,BA,42915,21298,21617,3160090230,072023,E155
3175,GRAZZANISE,CE,6741,3355,3386,3150200420,061042,E158
3176,GRAZZANO BADOGLIO,AT,577,289,288,1010070570,005057,E159
3177,GRECCIO,RI,1514,753,761,2120690290,057031,E160
3178,GRECI,AV,591,290,301,3150080370,064037,E161
3179,GREGGIO,VC,328,171,157,1010880650,002065,E163
3180,GREMIASCO,AL,292,149,143,1010020810,006083,E164
3181,GRESSAN,AO,3390,1678,1712,1020040300,007031,E165
3182,GRESSONEY-LA-TRINITE',AO,332,157,175,1020040310,007032,E167
3183,GRESSONEY-SAINT-JEAN,AO,799,397,402,1020040320,007033,E168
3184,GREVE IN CHIANTI,FI,13327,6542,6785,2090300210,048021,E169
3185,GREZZAGO,MI,3071,1571,1500,1030491090,015110,E170
3186,GREZZANA,VR,10717,5396,5321,1050890380,023038,E171
3187,GRIANTE,CO,591,295,296,1030241060,013113,E172
3188,GRICIGNANO DI AVERSA,CE,12628,6319,6309,3150200430,061043,E173
3189,GRIGNASCO,NO,4345,2106,2239,1010520760,003079,E177
3190,GRIGNO,TN,2030,1002,1028,1040830900,022095,E178
3191,GRIMACCO,UD,293,140,153,1060850450,030045,E179
3192,GRIMALDI,CS,1536,770,766,3180250600,078059,E180
3193,GRINZANE CAVOUR,CN,1987,989,998,1010271000,004100,E182
3194,GRISIGNANO DI ZOCCO,VI,4277,2115,2162,1050900460,024046,E184
3195,GRISOLIA,CS,2229,1095,1134,3180250610,078060,E185
3196,GRIZZANA MORANDI,BO,3883,1971,1912,1080130310,037031,E187
3197,GROGNARDO,AL,221,119,102,1010020820,006084,E188
3198,GROMO,BG,1134,599,535,1030121130,016118,E189
3199,GRONDONA,AL,476,228,248,1010020830,006085,E191
3200,GRONE,BG,865,446,419,1030121140,016119,E192
3201,GRONTARDO,CR,1489,754,735,1030260490,019050,E193
3202,GROPELLO CAIROLI,PV,4242,2076,2166,1030570730,018076,E195
3203,GROPPARELLO,PC,2127,1076,1051,1080610250,033025,E196
3204,GROSCAVALLO,TO,191,98,93,1010811160,001118,E199
3205,GROSIO,SO,4371,2098,2273,1030770330,014033,E200
3206,GROSOTTO,SO,1637,806,831,1030770340,014034,E201
3207,GROSSETO,GR,81503,39175,42328,2090360100,053011,E202
3208,GROSSO,TO,987,475,512,1010811170,001119,E203
3209,GROTTAFERRATA,RM,20455,9575,10880,2120700460,058046,E204
3210,GROTTAGLIE,TA,30869,14929,15940,3160780080,073008,E205
3211,GROTTAMINARDA,AV,7733,3802,3931,3150080380,064038,E206
3212,GROTTAMMARE,AP,15925,7646,8279,2110060230,044023,E207
3213,GROTTAZZOLINA,FM,3214,1572,1642,2111050080,109008,E208
3214,GROTTE,AG,5298,2504,2794,4190010180,084018,E209
3215,GROTTE DI CASTRO,VT,2442,1248,1194,2120910290,056030,E210
3216,GROTTERIA,RC,2881,1411,1470,3180670400,080040,E212
3217,GROTTOLE,MT,2063,1016,1047,3170470120,077012,E213
3218,GROTTOLELLA,AV,1816,911,905,3150080390,064039,E214
3219,GRUARO,VE,2741,1326,1415,1050870180,027018,E215
3220,GRUGLIASCO,TO,37090,17792,19298,1010811180,001120,E216
3221,GRUMELLO CREMONESE ED UNITI,CR,1692,849,843,1030260500,019051,E217
3222,GRUMELLO DEL MONTE,BG,7392,3656,3736,1030121150,016120,E219
3223,GRUMENTO NOVA,PZ,1568,778,790,3170640360,076037,E221
3224,GRUMO APPULA,BA,12284,6196,6088,3160090240,072024,E223
3225,GRUMO NEVANO,,17203,8686,8517,3150510360,063036,E224
3226,GRUMOLO DELLE ABBADESSE,VI,3808,1941,1867,1050900470,024047,E226
3227,GUAGNANO,LE,5486,2642,2844,3160410330,075034,E227
3228,GUALDO,MC,721,348,373,2110440210,043021,E228
3229,GUALDO CATTANEO,PG,5691,2914,2777,2100580220,054022,E229
3230,GUALDO TADINO,PG,14313,6792,7521,2100580230,054023,E230
3231,GUALTIERI,RE,6262,3143,3119,1080680230,035023,E232
3232,GUALTIERI SICAMINO',ME,1591,755,836,4190480340,083035,E233
3233,GUAMAGGIORE,SU,919,459,460,4201110320,111032,E234
3234,GUANZATE,CO,5795,2887,2908,1030241070,013114,E235
3235,GUARCINO,FR,1505,764,741,2120330420,060042,E236
3236,GUARDA VENETA,RO,1102,539,563,1050710280,029028,E240
3237,GUARDABOSONE,VC,334,165,169,1010880660,002066,E237
3238,GUARDAMIGLIO,LO,2634,1358,1276,1030990290,098029,E238
3239,GUARDAVALLE,CZ,4173,2006,2167,3180220590,079061,E239
3240,GUARDEA,TR,1750,862,888,2100800150,055015,E241
3241,GUARDIA LOMBARDI,AV,1526,735,791,3150080400,064040,E245
3242,GUARDIA PERTICARA,PZ,520,253,267,3170640370,076038,E246
3243,GUARDIA PIEMONTESE,CS,1726,832,894,3180250620,078061,E242
3244,GUARDIA SANFRAMONDI,BN,4638,2310,2328,3150110360,062037,E249
3245,GUARDIAGRELE,CH,8548,4214,4334,3130230430,069043,E243
3246,GUARDIALFIERA,CB,956,467,489,3140190270,070027,E244
3247,GUARDIAREGIA,CB,715,356,359,3140190280,070028,E248
3248,GUARDISTALLO,PI,1161,560,601,2090620150,050015,E250
3249,GUARENE,CN,3513,1741,1772,1010271010,004101,E251
3250,GUASILA,SU,2509,1260,1249,4201110330,111033,E252
3251,GUASTALLA,RE,14661,7167,7494,1080680240,035024,E253
3252,GUAZZORA,AL,292,145,147,1010020840,006086,E255
3253,GUBBIO,PG,30650,14920,15730,2100580240,054024,E256
3254,GUDO VISCONTI,MI,1634,801,833,1030491110,015112,E258
3255,GUGLIONESI,CB,4926,2496,2430,3140190290,070029,E259
3256,GUIDIZZOLO,MN,5971,2975,2996,1030450280,020028,E261
3257,GUIDONIA MONTECELIO,RM,88642,43989,44653,2120700470,058047,E263
3258,GUIGLIA,MO,4049,2047,2002,1080500170,036017,E264
3259,GUILMI,CH,404,208,196,3130230440,069044,E266
3260,GURRO,VB,190,92,98,1011020360,103036,E269
3261,GUSPINI,SU,11134,5505,5629,4201110340,111034,E270
3262,GUSSAGO,BS,16439,8064,8375,1030150750,017081,E271
3263,GUSSOLA,CR,2610,1298,1312,1030260510,019052,E272
3264,HONE,AO,1148,559,589,1020040330,007034,E273
3265,IDRO,BS,1873,941,932,1030150760,017082,E280
3266,IGLESIAS,SU,25382,12203,13179,4201110350,111035,E281
3267,IGLIANO,CN,67,36,31,1010271020,004102,E282
3268,ILBONO,NU,2004,985,1019,4200530300,091032,E283
3269,ILLASI,VR,5156,2608,2548,1050890390,023039,E284
3270,ILLORAI,SS,763,348,415,4200730310,090031,E285
3271,IMBERSAGO,LC,2480,1227,1253,1030980390,097039,E287
3272,IMER,TN,1171,609,562,1040830920,022097,E288
3273,IMOLA,BO,69551,33608,35943,1080130320,037032,E289
3274,IMPERIA,IM,41960,20479,21481,1070370290,008031,E290
3275,IMPRUNETA,FI,14477,6969,7508,2090300220,048022,E291
3276,INARZO,VA,1061,513,548,1030860692,012082,E292
3277,INCISA SCAPACCINO,AT,2028,1032,996,1010070580,005058,E295
3278,INCUDINE,BS,345,166,179,1030150770,017083,E297
3279,INDUNO OLONA,VA,10278,5058,5220,1030860700,012083,E299
3280,INGRIA,TO,42,25,17,1010811190,001121,E301
3281,INTRAGNA,VB,100,55,45,1011020370,103037,E304
3282,INTROBIO,LC,1919,972,947,1030980400,097040,E305
3283,INTROD,AO,642,331,311,1020040340,007035,E306
3284,INTRODACQUA,AQ,1973,975,998,3130380480,066048,E307
3285,INVERIGO,CO,9117,4519,4598,1030241110,013118,E309
3286,INVERNO E MONTELEONE,PV,1452,740,712,1030570740,018077,E310
3287,INVERSO PINASCA,TO,697,350,347,1010811200,001122,E311
3288,INVERUNO,MI,8487,4125,4362,1030491120,015113,E313
3289,INVORIO,NO,4308,2120,2188,1010520790,003082,E314
3290,INZAGO,MI,11245,5578,5667,1030491130,015114,E317
3291,IRGOLI,NU,2232,1123,1109,4200530310,091033,E323
3292,IRMA,BS,136,75,61,1030150771,017084,E325
3293,IRSINA,MT,4441,2208,2233,3170470130,077013,E326
3294,ISASCA,CN,72,42,30,1010271030,004103,E327
3295,ISCA SULLO IONIO,CZ,1491,735,756,3180220610,079063,E328
3296,ISCHIA,,19542,9721,9821,3150510370,063037,E329
3297,ISCHIA DI CASTRO,VT,2188,1049,1139,2120910300,056031,E330
3298,ISCHITELLA,FG,4155,2068,2087,3160310240,071025,E332
3299,ISEO,BS,8924,4272,4652,1030150780,017085,E333
3300,ISERA,TN,2776,1376,1400,1040830930,022098,E334
3301,ISERNIA,IS,20748,9986,10762,3140940230,094023,E335
3302,ISILI,SU,2503,1224,1279,4201110360,111036,E336
3303,ISNELLO,PA,1334,638,696,4190550400,082042,E337
3304,ISOLA D'ASTI,AT,1964,964,1000,1010070590,005059,E338
3305,ISOLA DEL CANTONE,GE,1392,701,691,1070340270,010027,E341
3306,ISOLA DEL GIGLIO,GR,1344,714,630,2090360110,053012,E348
3307,ISOLA DEL GRAN SASSO D'ITALIA,TE,4472,2217,2255,3130790250,067026,E343
3308,ISOLA DEL LIRI,FR,10854,5230,5624,2120330430,060043,E340
3309,ISOLA DEL PIANO,PU,556,280,276,2110590210,041021,E351
3310,ISOLA DELLA SCALA,VR,11528,5809,5719,1050890400,023040,E349
3311,ISOLA DELLE FEMMINE,PA,7084,3526,3558,4190550410,082043,E350
3312,ISOLA DI CAPO RIZZUTO,KR,17281,8958,8323,3180970130,101013,E339
3313,ISOLA DI FONDRA,BG,171,89,82,1030121160,016121,E353
3314,ISOLA DOVARESE,CR,1091,548,543,1030260520,019053,E356
3315,ISOLA RIZZA,VR,3230,1631,1599,1050890410,023041,E358
3316,ISOLA SANT'ANTONIO,AL,644,332,312,1010020850,006087,E360
3317,ISOLA VICENTINA,VI,10268,5104,5164,1050900480,024048,E354
3318,ISOLABELLA,TO,375,185,190,1010811210,001123,E345
3319,ISOLABONA,IM,677,334,343,1070370300,008032,E346
3320,ISOLE TREMITI,FG,464,266,198,3160310250,071026,E363
3321,ISORELLA,BS,4064,2074,1990,1030150790,017086,E364
3322,ISPANI,SA,988,493,495,3150720590,065059,E365
3323,ISPICA,RG,16187,8305,7882,4190650050,088005,E366
3324,ISPRA,VA,5297,2558,2739,1030860710,012084,E367
3325,ISSIGLIO,TO,409,200,209,1010811220,001124,E368
3326,ISSIME,AO,378,188,190,1020040350,007036,E369
3327,ISSO,BG,622,323,299,1030121170,016122,E370
3328,ISSOGNE,AO,1323,660,663,1020040360,007037,E371
3329,ISTRANA,TV,9088,4692,4396,1050840340,026035,E373
3330,ITALA,ME,1495,719,776,4190480350,083036,E374
3331,ITRI,LT,10371,5248,5123,2120400100,059010,E375
3332,ITTIREDDU,SS,481,247,234,4200730320,090032,E376
3333,ITTIRI,SS,8097,3987,4110,4200730330,090033,E377
3334,IVREA,TO,22604,10774,11830,1010811230,001125,E379
3335,IZANO,CR,1949,973,976,1030260530,019054,E380
3336,JACURSO,CZ,562,263,299,3180220630,079065,E274
3337,JELSI,CB,1638,833,805,3140190300,070030,E381
3338,JENNE,RM,336,165,171,2120700480,058048,E382
3339,JERAGO CON ORAGO,VA,5273,2609,2664,1030860720,012085,E386
3340,JERZU,NU,3054,1507,1547,4200530330,091035,E387
3341,JESI,AN,39217,18896,20321,2110030210,042021,E388
3342,JESOLO,VE,26556,12892,13664,1050870190,027019,C388
3343,JOLANDA DI SAVOIA,FE,2638,1282,1356,1080290100,038010,E320
3344,JONADI,VV,4502,2209,2293,3181030170,102017,E321
3345,JOPPOLO,VV,1671,839,832,3181030180,102018,E389
3346,JOPPOLO GIANCAXIO,AG,1084,514,570,4190010190,084019,E390
3347,JOVENCAN,AO,716,359,357,1020040370,007038,E391
3348,L'AQUILA,AQ,69210,34088,35122,3130380490,066049,A345
3349,LA CASSA,TO,1773,900,873,1010811240,001126,E394
3350,LA LOGGIA,TO,8779,4363,4416,1010811250,001127,E423
3351,LA MADDALENA,SS,10687,5314,5373,4200730350,090035,E425
3352,LA MAGDELEINE,AO,108,64,44,1020040380,007039,A308
3353,LA MORRA,CN,2675,1361,1314,1010271050,004105,E430
3354,LA SALLE,AO,2021,1017,1004,1020040390,007040,E458
3355,LA SPEZIA,SP,92169,44414,47755,1070390150,011015,E463
3356,LA THUILE,AO,816,414,402,1020040400,007041,E470
3357,LA VALLE AGORDINA,BL,1060,542,518,1050100270,025027,E490
3358,LA VALLE/WENGEN,BZ,1402,730,672,1040140401,021117,E491
3359,LA VALLETTA BRIANZA,LC,4670,2351,2319,1030980415,097092,M348
3360,LABICO,RM,6449,3192,3257,2120700490,058049,E392
3361,LABRO,RI,372,185,187,2120690300,057032,E393
3362,LACCHIARELLA,MI,9060,4427,4633,1030491140,015115,E395
3363,LACCO AMENO,,4642,2269,2373,3150510380,063038,E396
3364,LACEDONIA,AV,2064,1028,1036,3150080410,064041,E397
3365,LACES/LATSCH,BZ,5202,2594,2608,1040140340,021037,E398
3366,LACONI,OR,1685,831,854,4200950246,095082,E400
3367,LADISPOLI,RM,40593,19825,20768,2120700491,058116,M212
3368,LAERRU,SS,859,426,433,4200730340,090034,E401
3369,LAGANADI,RC,352,175,177,3180670410,080041,E402
3370,LAGHI,VI,120,63,57,1050900490,024049,E403
3371,LAGLIO,CO,899,423,476,1030241120,013119,E405
3372,LAGNASCO,CN,1395,732,663,1010271040,004104,E406
3373,LAGO,CS,2303,1132,1171,3180250630,078062,E407
3374,LAGONEGRO,PZ,5138,2480,2658,3170640380,076039,E409
3375,LAGOSANTO,FE,4730,2279,2451,1080290110,038011,E410
3376,LAGUNDO/ALGUND,BZ,5050,2438,2612,1040140350,021038,E412
3377,LAIGUEGLIA,SV,1696,787,909,1070740330,009033,E414
3378,LAINATE,MI,26126,12797,13329,1030491150,015116,E415
3379,LAINO,CO,544,278,266,1030241130,013120,E416
3380,LAINO BORGO,CS,1737,852,885,3180250640,078063,E417
3381,LAINO CASTELLO,CS,789,363,426,3180250650,078064,E419
3382,LAION/LAJEN,BZ,2743,1368,1375,1040140360,021039,E420
3383,LAIVES/LEIFERS,BZ,18183,9101,9082,1040140370,021040,E421
3384,LAJATICO,PI,1282,626,656,2090620160,050016,E413
3385,LALLIO,BG,4119,2036,2083,1030121180,016123,E422
3386,LAMA DEI PELIGNI,CH,1087,517,570,3130230450,069045,E424
3387,LAMA MOCOGNO,MO,2667,1337,1330,1080500180,036018,E426
3388,LAMBRUGO,CO,2523,1243,1280,1030241140,013121,E428
3389,LAMEZIA TERME,CZ,67413,33186,34227,3180220641,079160,M208
3390,LAMON,BL,2666,1301,1365,1050100260,025026,E429
3391,LAMPEDUSA E LINOSA,AG,6462,3374,3088,4190010200,084020,E431
3392,LAMPORECCHIO,PT,7398,3595,3803,2090630050,047005,E432
3393,LAMPORO,VC,506,253,253,1010880670,002067,E433
3394,LANA/LANA,BZ,12415,6066,6349,1040140380,021041,E434
3395,LANCIANO,CH,34201,16472,17729,3130230460,069046,E435
3396,LANDIONA,NO,537,255,282,1010520800,003083,E436
3397,LANDRIANO,PV,6446,3214,3232,1030570750,018078,E437
3398,LANGHIRANO,PR,10661,5323,5338,1080560180,034018,E438
3399,LANGOSCO,PV,382,186,196,1030570760,018079,E439
3400,LANUSEI,NU,5091,2527,2564,4200530350,091037,E441
3401,LANUVIO,RM,12936,6472,6464,2120700500,058050,C767
3402,LANZADA,SO,1256,657,599,1030770360,014036,E443
3403,LANZO TORINESE,TO,4893,2376,2517,1010811260,001128,E445
3404,LAPEDONA,FM,1159,590,569,2111050090,109009,E447
3405,LAPIO,AV,1446,735,711,3150080420,064042,E448
3406,LAPPANO,CS,884,452,432,3180250660,078065,E450
3407,LARCIANO,PT,6312,3101,3211,2090630060,047006,E451
3408,LARDIRAGO,PV,1138,594,544,1030570770,018080,E454
3409,LARIANO,RM,13200,6521,6679,2120700501,058115,M207
3410,LARINO,CB,6409,3154,3255,3140190310,070031,E456
3411,LAS PLASSAS,SU,215,118,97,4201110370,111037,E464
3412,LASA/LAAS,BZ,4078,2041,2037,1040140390,021042,E457
3413,LASCARI,PA,3674,1785,1889,4190550420,082044,E459
3414,LASNIGO,CO,456,229,227,1030241160,013123,E462
3415,LASTEBASSE,VI,189,93,96,1050900500,024050,E465
3416,LASTRA A SIGNA,FI,19674,9656,10018,2090300240,048024,E466
3417,LATERA,VT,777,416,361,2120910310,056032,E467
3418,LATERINA PERGINE VALDARNO,AR,6447,3201,3246,2090050191,051042,M392
3419,LATERZA,TA,14906,7337,7569,3160780090,073009,E469
3420,LATIANO,BR,13660,6618,7042,3160160090,074009,E471
3421,LATINA,LT,127861,62568,65293,2120400110,059011,E472
3422,LATISANA,UD,13201,6367,6834,1060850460,030046,E473
3423,LATRONICO,PZ,4129,2033,2096,3170640390,076040,E474
3424,LATTARICO,CS,3774,1861,1913,3180250670,078066,E475
3425,LAUCO,UD,663,338,325,1060850470,030047,E476
3426,LAUREANA CILENTO,SA,1225,620,605,3150720600,065060,E480
3427,LAUREANA DI BORRELLO,RC,4699,2245,2454,3180670420,080042,E479
3428,LAUREGNO/LAUREIN,BZ,325,180,145,1040140400,021043,E481
3429,LAURENZANA,PZ,1625,805,820,3170640400,076041,E482
3430,LAURIA,PZ,12017,5821,6196,3170640410,076042,E483
3431,LAURIANO,TO,1401,696,705,1010811270,001129,E484
3432,LAURINO,SA,1309,661,648,3150720610,065061,E485
3433,LAURITO,SA,712,356,356,3150720620,065062,E486
3434,LAURO,AV,3330,1589,1741,3150080430,064043,E487
3435,LAVAGNA,GE,12315,5760,6555,1070340280,010028,E488
3436,LAVAGNO,VR,8546,4226,4320,1050890420,023042,E489
3437,LAVARONE,TN,1187,596,591,1040830950,022102,E492
3438,LAVELLO,PZ,13028,6579,6449,3170640420,076043,E493
3439,LAVENA PONTE TRESA,VA,5631,2692,2939,1030860730,012086,E494
3440,LAVENO-MOMBELLO,VA,8324,3886,4438,1030860740,012087,E496
3441,LAVENONE,BS,486,247,239,1030150800,017087,E497
3442,LAVIANO,SA,1338,659,679,3150720630,065063,E498
3443,LAVIS,TN,9126,4551,4575,1040830960,022103,E500
3444,LAZISE,VR,6849,3394,3455,1050890430,023043,E502
3445,LAZZATE,MB,7699,3812,3887,1031040250,108025,E504
3446,LECCE,LE,94783,45044,49739,3160410340,075035,E506
3447,LECCE NEI MARSI,AQ,1543,749,794,3130380500,066050,E505
3448,LECCO,LC,46831,22561,24270,1030980420,097042,E507
3449,LEDRO,TN,5273,2574,2699,1040830965,022229,M313
3450,LEFFE,BG,4308,2150,2158,1030121190,016124,E509
3451,LEGGIUNO,VA,3618,1740,1878,1030860750,012088,E510
3452,LEGNAGO,VR,25313,12225,13088,1050890440,023044,E512
3453,LEGNANO,MI,59955,28953,31002,1030491170,015118,E514
3454,LEGNARO,PD,9353,4668,4685,1050540440,028044,E515
3455,LEI,NU,470,239,231,4200530360,091038,E517
3456,LEINI,TO,16321,8081,8240,1010811280,001130,E518
3457,LEIVI,GE,2404,1164,1240,1070340290,010029,E519
3458,LEMIE,TO,185,105,80,1010811290,001131,E520
3459,LENDINARA,RO,11457,5596,5861,1050710290,029029,E522
3460,LENI,ME,681,346,335,4190480360,083037,E523
3461,LENNA,BG,554,264,290,1030121191,016125,E524
3462,LENO,BS,14243,7165,7078,1030150810,017088,E526
3463,LENOLA,LT,4072,2028,2044,2120400120,059012,E527
3464,LENTA,VC,795,400,395,1010880680,002068,E528
3465,LENTATE SUL SEVESO,MB,15802,7860,7942,1031040255,108054,E530
3466,LENTELLA,CH,649,323,326,3130230470,069047,E531
3467,LENTINI,SR,21926,10648,11278,4190760110,089011,E532
3468,LEONESSA,RI,2149,1077,1072,2120690310,057033,E535
3469,LEONFORTE,EN,12513,6096,6417,4190280110,086011,E536
3470,LEPORANO,TA,8187,4119,4068,3160780100,073010,E537
3471,LEQUILE,LE,8688,4215,4473,3160410350,075036,E538
3472,LEQUIO BERRIA,CN,432,232,200,1010271060,004106,E540
3473,LEQUIO TANARO,CN,752,381,371,1010271070,004107,E539
3474,LERCARA FRIDDI,PA,6329,2989,3340,4190550430,082045,E541
3475,LERICI,SP,9497,4506,4991,1070390160,011016,E542
3476,LERMA,AL,801,380,421,1010020860,006088,E543
3477,LESA,NO,2152,1033,1119,1010520810,003084,E544
3478,LESEGNO,CN,788,392,396,1010271080,004108,E546
3479,LESIGNANO DE' BAGNI,PR,5054,2553,2501,1080560190,034019,E547
3480,LESINA,FG,6220,3111,3109,3160310260,071027,E549
3481,LESMO,MB,8419,4182,4237,1031040260,108026,E550
3482,LESSOLO,TO,1777,859,918,1010811300,001132,E551
3483,LESSONA,BI,2634,1290,1344,1010960291,096085,M371
3484,LESTIZZA,UD,3677,1832,1845,1060850480,030048,E553
3485,LETINO,CE,640,301,339,3150200440,061044,E554
3486,LETOJANNI,ME,2808,1384,1424,4190480370,083038,E555
3487,LETTERE,,6073,3091,2982,3150510390,063039,E557
3488,LETTOMANOPPELLO,PE,2713,1334,1379,3130600200,068020,E558
3489,LETTOPALENA,CH,320,173,147,3130230480,069048,E559
3490,LEVANTO,SP,5218,2462,2756,1070390170,011017,E560
3491,LEVATE,BG,3720,1865,1855,1030121200,016126,E562
3492,LEVERANO,LE,13763,6671,7092,3160410360,075037,E563
3493,LEVICE,CN,204,104,100,1010271090,004109,E564
3494,LEVICO TERME,TN,8134,3952,4182,1040830970,022104,E565
3495,LEVONE,TO,443,217,226,1010811310,001133,E566
3496,LEZZENO,CO,1962,977,985,1030241190,013126,E569
3497,LIBERI,CE,1087,524,563,3150200450,061045,E570
3498,LIBRIZZI,ME,1584,768,816,4190480380,083039,E571
3499,LICATA,AG,34619,17030,17589,4190010210,084021,E573
3500,LICCIANA NARDI,MS,4739,2329,2410,2090460090,045009,E574
3501,LICENZA,RM,891,447,444,2120700510,058051,E576
3502,LICODIA EUBEA,CT,2762,1402,1360,4190210200,087020,E578
3503,LIERNA,LC,2167,1091,1076,1030980430,097043,E581
3504,LIGNANA,VC,529,254,275,1010880700,002070,E583
3505,LIGNANO SABBIADORO,UD,6833,3365,3468,1060850490,030049,E584
3506,LILLIANES,AO,432,207,225,1020040410,007042,E587
3507,LIMANA,BL,5340,2643,2697,1050100290,025029,E588
3508,LIMATOLA,BN,4151,2127,2024,3150110370,062038,E589
3509,LIMBADI,VV,3267,1629,1638,3181030190,102019,E590
3510,LIMBIATE,MB,34809,17297,17512,1031040270,108027,E591
3511,LIMENA,PD,8097,3986,4111,1050540450,028045,E592
3512,LIMIDO COMASCO,CO,3864,1926,1938,1030241220,013128,E593
3513,LIMINA,ME,738,345,393,4190480390,083040,E594
3514,LIMONE PIEMONTE,CN,1402,711,691,1010271100,004110,E597
3515,LIMONE SUL GARDA,BS,1141,555,586,1030150820,017089,E596
3516,LIMOSANO,CB,699,369,330,3140190320,070032,E599
3517,LINAROLO,PV,2810,1397,1413,1030570780,018081,E600
3518,LINGUAGLOSSA,CT,4995,2443,2552,4190210210,087021,E602
3519,LIONI,AV,6016,2951,3065,3150080440,064044,E605
3520,LIPARI,ME,12508,6381,6127,4190480400,083041,E606
3521,LIPOMO,CO,5985,2922,3063,1030241230,013129,E607
3522,LIRIO,PV,134,75,59,1030570790,018082,E608
3523,LISCATE,MI,4009,2043,1966,1030491210,015122,E610
3524,LISCIA,CH,648,336,312,3130230490,069049,E611
3525,LISCIANO NICCONE,PG,596,292,304,2100580250,054025,E613
3526,LISIO,CN,191,93,98,1010271110,004111,E615
3527,LISSONE,MB,46191,22688,23503,1031040280,108028,E617
3528,LIVERI,,1504,728,776,3150510400,063040,E620
3529,LIVIGNO,SO,6811,3522,3289,1030770370,014037,E621
3530,LIVINALLONGO DEL COL DI LANA,BL,1263,606,657,1050100300,025030,E622
3531,LIVO,TN,781,403,378,1040830990,022106,E624
3532,LIVO,TN,781,403,378,1030241240,013130,E623
3533,LIVO,CO,165,93,72,1040830990,022106,E624
3534,LIVO,CO,165,93,72,1030241240,013130,E623
3535,LIVORNO,LI,154483,74340,80143,2090420090,049009,E625
3536,LIVORNO FERRARIS,VC,4180,2021,2159,1010880710,002071,E626
3537,LIVRAGA,LO,2423,1206,1217,1030990300,098030,E627
3538,LIZZANELLO,LE,11840,5767,6073,3160410370,075038,E629
3539,LIZZANO,TA,9628,4730,4898,3160780110,073011,E630
3540,LIZZANO IN BELVEDERE,BO,2172,1082,1090,1080130330,037033,A771
3541,LOANO,SV,10788,5044,5744,1070740340,009034,E632
3542,LOAZZOLO,AT,296,153,143,1010070600,005060,E633
3543,LOCANA,TO,1339,644,695,1010811320,001134,E635
3544,LOCATE DI TRIULZI,MI,10264,5051,5213,1030491240,015125,E639
3545,LOCATE VARESINO,CO,4303,2159,2144,1030241250,013131,E638
3546,LOCATELLO,BG,823,411,412,1030121210,016127,E640
3547,LOCERI,NU,1279,623,656,4200530370,091039,E644
3548,LOCOROTONDO,BA,13978,6834,7144,3160090250,072025,E645
3549,LOCRI,RC,11922,5750,6172,3180670430,080043,D976
3550,LOCULI,NU,508,272,236,4200530380,091040,E646
3551,LODE',NU,1529,786,743,4200530390,091041,E647
3552,LODI,LO,44716,21594,23122,1030990310,098031,E648
3553,LODI VECCHIO,LO,7485,3638,3847,1030990320,098032,E651
3554,LODINE,NU,307,160,147,4200530391,091104,E649
3555,LODRINO,BS,1624,848,776,1030150830,017090,E652
3556,LOGRATO,BS,3804,1914,1890,1030150840,017091,E654
3557,LOIANO,BO,4369,2173,2196,1080130340,037034,E655
3558,LOIRI PORTO SAN PAOLO,SS,3659,1857,1802,4200730351,090084,M275
3559,LOMAGNA,LC,5026,2491,2535,1030980440,097044,E656
3560,LOMAZZO,CO,9944,4870,5074,1030241270,013133,E659
3561,LOMBARDORE,TO,1670,849,821,1010811330,001135,E660
3562,LOMBRIASCO,TO,1090,567,523,1010811340,001136,E661
3563,LOMELLO,PV,2022,966,1056,1030570800,018083,E662
3564,LONA-LASES,TN,873,435,438,1040831010,022108,E664
3565,LONATE CEPPINO,VA,5033,2482,2551,1030860760,012089,E665
3566,LONATE POZZOLO,VA,11366,5635,5731,1030860770,012090,E666
3567,LONATO DEL GARDA,BS,16827,8333,8494,1030150850,017092,M312
3568,LONDA,FI,1824,949,875,2090300250,048025,E668
3569,LONGANO,IS,637,321,316,3140940240,094024,E669
3570,LONGARE,VI,5523,2782,2741,1050900510,024051,E671
3571,LONGARONE,BL,5078,2471,2607,1050100311,025071,M342
3572,LONGHENA,BS,560,296,264,1030150860,017093,E673
3573,LONGI,ME,1350,655,695,4190480410,083042,E674
3574,LONGIANO,FC,7225,3546,3679,1080320170,040018,E675
3575,LONGOBARDI,CS,2326,1192,1134,3180250680,078067,E677
3576,LONGOBUCCO,CS,2700,1335,1365,3180250690,078068,E678
3577,LONGONE AL SEGRINO,CO,1947,960,987,1030241280,013134,E679
3578,LONGONE SABINO,RI,541,279,262,2120690320,057034,E681
3579,LONIGO,VI,15746,7903,7843,1050900520,024052,E682
3580,LORANZE',TO,1149,572,577,1010811350,001137,E683
3581,LOREGGIA,PD,7659,3888,3771,1050540460,028046,E684
3582,LOREGLIA,VB,217,107,110,1011020380,103038,E685
3583,LORENZAGO DI CADORE,BL,575,289,286,1050100320,025032,E687
3584,LOREO,RO,3275,1624,1651,1050710300,029030,E689
3585,LORETO,AN,12843,6211,6632,2110030220,042022,E690
3586,LORETO APRUTINO,PE,7156,3542,3614,3130600210,068021,E691
3587,LORIA,TV,9313,4781,4532,1050840350,026036,E692
3588,LORO CIUFFENNA,AR,5854,2907,2947,2090050200,051020,E693
3589,LORO PICENO,MC,2181,1058,1123,2110440220,043022,E694
3590,LORSICA,GE,412,202,210,1070340300,010030,E695
3591,LOSINE,BS,625,316,309,1030150870,017094,E698
3592,LOTZORAI,NU,2116,1019,1097,4200530400,091042,E700
3593,LOVERE,BG,5001,2313,2688,1030121220,016128,E704
3594,LOVERO,SO,627,321,306,1030770380,014038,E705
3595,LOZIO,BS,353,178,175,1030150880,017095,E706
3596,LOZZA,VA,1203,591,612,1030860780,012091,E707
3597,LOZZO ATESTINO,PD,2981,1500,1481,1050540470,028047,E709
3598,LOZZO DI CADORE,BL,1272,616,656,1050100330,025033,E708
3599,LOZZOLO,VC,797,391,406,1010880720,002072,E711
3600,LU E CUCCARO MONFERRATO,AL,1330,650,680,1010020875,006193,M420
3601,LUBRIANO,VT,888,427,461,2120910320,056033,E713
3602,LUCCA,LU,89078,42788,46290,2090430170,046017,E715
3603,LUCCA SICULA,AG,1733,844,889,4190010220,084022,E714
3604,LUCERA,FG,31458,15310,16148,3160310270,071028,E716
3605,LUCIGNANO,AR,3396,1648,1748,2090050210,051021,E718
3606,LUCINASCO,IM,293,162,131,1070370301,008033,E719
3607,LUCITO,CB,630,308,322,3140190330,070033,E722
3608,LUCO DEI MARSI,AQ,5996,3055,2941,3130380510,066051,E723
3609,LUCOLI,AQ,872,455,417,3130380520,066052,E724
3610,LUGAGNANO VAL D'ARDA,PC,3880,1937,1943,1080610260,033026,E726
3611,LUGNANO IN TEVERINA,TR,1431,728,703,2100800160,055016,E729
3612,LUGO,RA,31919,15421,16498,1080660120,039012,E730
3613,LUGO DI VICENZA,VI,3562,1795,1767,1050900530,024053,E731
3614,LUINO,VA,14128,6811,7317,1030860790,012092,E734
3615,LUISAGO,CO,2730,1355,1375,1030241290,013135,E735
3616,LULA,NU,1266,642,624,4200530410,091043,E736
3617,LUMARZO,GE,1433,724,709,1070340310,010031,E737
3618,LUMEZZANE,BS,21410,10667,10743,1030150890,017096,E738
3619,LUNAMATRONA,SU,1649,798,851,4201110380,111038,E742
3620,LUNANO,PU,1434,763,671,2110590220,041022,E743
3621,LUNGAVILLA,PV,2457,1179,1278,1030570810,018084,B387
3622,LUNGRO,CS,2227,1112,1115,3180250700,078069,E745
3623,LUNI,SP,8208,4022,4186,1070390200,011020,G143
3624,LUOGOSANO,AV,1097,571,526,3150080450,064045,E746
3625,LUOGOSANTO,SS,1818,920,898,4200730360,090036,E747
3626,LUPARA,CB,415,203,212,3140190340,070034,E748
3627,LURAGO D'ERBA,CO,5405,2672,2733,1030241300,013136,E749
3628,LURAGO MARINONE,CO,2553,1278,1275,1030241310,013137,E750
3629,LURANO,BG,2811,1439,1372,1030121230,016129,E751
3630,LURAS,SS,2429,1182,1247,4200730370,090037,E752
3631,LURATE CACCIVIO,CO,9708,4749,4959,1030241320,013138,E753
3632,LUSCIANO,CE,15842,7726,8116,3150200460,061046,E754
3633,LUSERNA,TN,270,131,139,1040831020,022109,E757
3634,LUSERNA SAN GIOVANNI,TO,7162,3448,3714,1010811370,001139,E758
3635,LUSERNETTA,TO,480,247,233,1010811380,001140,E759
3636,LUSEVERA,UD,585,284,301,1060850510,030051,E760
3637,LUSIA,RO,3323,1650,1673,1050710310,029031,E761
3638,LUSIANA CONCO,VI,4553,2315,2238,1050900541,024127,M427
3639,LUSIGLIE',TO,541,262,279,1010811390,001141,E763
3640,LUSON/LUSEN,BZ,1546,771,775,1040140410,021044,E764
3641,LUSTRA,SA,994,501,493,3150720640,065064,E767
3642,LUVINATE,VA,1310,650,660,1030860791,012093,E769
3643,LUZZANA,BG,881,456,425,1030121240,016130,E770
3644,LUZZARA,RE,8402,4256,4146,1080680260,035026,E772
3645,LUZZI,CS,8796,4308,4488,3180250710,078070,E773
3646,MACCAGNO CON PINO E VEDDASCA,VA,2403,1174,1229,1030860801,012142,M339
3647,MACCASTORNA,LO,63,35,28,1030990330,098033,E777
3648,MACCHIA D'ISERNIA,IS,1030,528,502,3140940250,094025,E778
3649,MACCHIA VALFORTORE,CB,490,246,244,3140190350,070035,E780
3650,MACCHIAGODENA,IS,1655,812,843,3140940260,094026,E779
3651,MACELLO,TO,1155,573,582,1010811400,001142,E782
3652,MACERATA,MC,40503,19412,21091,2110440230,043023,E783
3653,MACERATA CAMPANIA,CE,10048,4942,5106,3150200470,061047,E784
3654,MACERATA FELTRIA,PU,1915,889,1026,2110590230,041023,E785
3655,MACHERIO,MB,7449,3678,3771,1031040290,108029,E786
3656,MACLODIO,BS,1483,752,731,1030150900,017097,E787
3657,MACOMER,NU,9444,4588,4856,4200530420,091044,E788
3658,MACRA,CN,43,24,19,1010271120,004112,E789
3659,MACUGNAGA,VB,526,270,256,1011020390,103039,E790
3660,MADDALONI,CE,37146,18135,19011,3150200480,061048,E791
3661,MADESIMO,SO,530,274,256,1030770381,014035,E342
3662,MADIGNANO,CR,2760,1385,1375,1030260540,019055,E793
3663,MADONE,BG,4025,2038,1987,1030121250,016131,E794
3664,MADONNA DEL SASSO,VB,371,186,185,1011020400,103040,E795
3665,MADRUZZO,TN,2963,1522,1441,1040831031,022243,M357
3666,MAENZA,LT,2977,1452,1525,2120400130,059013,E798
3667,MAFALDA,CB,1092,553,539,3140190360,070036,E799
3668,MAGASA,BS,107,58,49,1030150910,017098,E800
3669,MAGENTA,MI,24130,11676,12454,1030491290,015130,E801
3670,MAGGIORA,NO,1609,775,834,1010520840,003088,E803
3671,MAGHERNO,PV,1754,873,881,1030570820,018085,E804
3672,MAGIONE,PG,14602,7128,7474,2100580260,054026,E805
3673,MAGISANO,CZ,1111,544,567,3180220660,079068,E806
3674,MAGLIANO ALFIERI,CN,2173,1059,1114,1010271130,004113,E809
3675,MAGLIANO ALPI,CN,2130,1056,1074,1010271140,004114,E808
3676,MAGLIANO DE' MARSI,AQ,3525,1718,1807,3130380530,066053,E811
3677,MAGLIANO DI TENNA,FM,1432,715,717,2111050100,109010,E807
3678,MAGLIANO IN TOSCANA,GR,3316,1597,1719,2090360120,053013,E810
3679,MAGLIANO ROMANO,RM,1415,711,704,2120700511,058052,E813
3680,MAGLIANO SABINA,RI,3483,1719,1764,2120690330,057035,E812
3681,MAGLIANO VETERE,SA,606,290,316,3150720650,065065,E814
3682,MAGLIE,LE,13619,6407,7212,3160410380,075039,E815
3683,MAGLIOLO,SV,933,482,451,1070740350,009035,E816
3684,MAGLIONE,TO,419,206,213,1010811410,001143,E817
3685,MAGNACAVALLO,MN,1428,716,712,1030450290,020029,E818
3686,MAGNAGO,MI,9336,4630,4706,1030491300,015131,E819
3687,MAGNANO,BI,366,198,168,1010960300,096030,E821
3688,MAGNANO IN RIVIERA,UD,2273,1125,1148,1060850520,030052,E820
3689,MAGOMADAS,OR,604,316,288,4200950247,095083,E825
3690,MAGRE' SULLA STRADA DEL VINO/MARGREID AN DER WEINSTRASSE,BZ,1292,632,660,1040140420,021045,E829
3691,MAGREGLIO,CO,687,347,340,1030241330,013139,E830
3692,MAIDA,CZ,4428,2174,2254,3180220670,079069,E834
3693,MAIERA',CS,1139,577,562,3180250720,078071,E835
3694,MAIERATO,VV,2056,992,1064,3181030200,102020,E836
3695,MAIOLATI SPONTINI,AN,6097,2919,3178,2110030230,042023,E837
3696,MAIOLO,RN,785,403,382,1081010045,099022,E838
3697,MAIORI,SA,5397,2663,2734,3150720660,065066,E839
3698,MAIRAGO,LO,1385,696,689,1030990340,098034,E840
3699,MAIRANO,BS,3492,1768,1724,1030150920,017099,E841
3700,MAISSANA,SP,583,321,262,1070390180,011018,E842
3701,MAJANO,UD,5834,2805,3029,1060850530,030053,E833
3702,MALAGNINO,CR,1719,845,874,1030260550,019056,E843
3703,MALALBERGO,BO,9045,4383,4662,1080130350,037035,E844
3704,MALBORGHETTO VALBRUNA,UD,910,466,444,1060850540,030054,E847
3705,MALCESINE,VR,3596,1737,1859,1050890450,023045,E848
3706,MALE',TN,2265,1092,1173,1040831040,022110,E850
3707,MALEGNO,BS,1960,981,979,1030150930,017100,E851
3708,MALEO,LO,3017,1480,1537,1030990350,098035,E852
3709,MALESCO,VB,1360,675,685,1011020410,103041,E853
3710,MALETTO,CT,3598,1742,1856,4190210220,087022,E854
3711,MALFA,ME,978,498,480,4190480420,083043,E855
3712,MALGRATE,LC,4296,2076,2220,1030980450,097045,E858
3713,MALITO,CS,747,369,378,3180250730,078072,E859
3714,MALLARE,SV,1061,512,549,1070740360,009036,E860
3715,MALLES VENOSTA/MALS,BZ,5233,2672,2561,1040140430,021046,E862
3716,MALNATE,VA,16347,7930,8417,1030860820,012096,E863
3717,MALO,VI,14682,7343,7339,1050900550,024055,E864
3718,MALONNO,BS,3030,1481,1549,1030150940,017101,E865
3719,MALTIGNANO,AP,2259,1116,1143,2110060270,044027,E868
3720,MALVAGNA,ME,639,300,339,4190480430,083044,E869
3721,MALVICINO,AL,79,35,44,1010020880,006090,E870
3722,MALVITO,CS,1661,837,824,3180250740,078073,E872
3723,MAMMOLA,RC,2498,1217,1281,3180670440,080044,E873
3724,MAMOIADA,NU,2426,1185,1241,4200530440,091046,E874
3725,MANCIANO,GR,7113,3450,3663,2090360130,053014,E875
3726,MANDANICI,ME,531,256,275,4190480440,083045,E876
3727,MANDAS,SU,2028,1021,1007,4201110390,111039,E877
3728,MANDATORICCIO,CS,2455,1224,1231,3180250750,078074,E878
3729,MANDELA,RM,906,452,454,2120700520,058053,B632
3730,MANDELLO DEL LARIO,LC,10014,4925,5089,1030980460,097046,E879
3731,MANDELLO VITTA,NO,228,110,118,1010520851,003090,E880
3732,MANDURIA,TA,30117,14639,15478,3160780120,073012,E882
3733,MANERBA DEL GARDA,BS,5415,2713,2702,1030150950,017102,E883
3734,MANERBIO,BS,13163,6447,6716,1030150960,017103,E884
3735,MANFREDONIA,FG,54342,27023,27319,3160310280,071029,E885
3736,MANGO,CN,1253,635,618,1010271150,004115,E887
3737,MANGONE,CS,1885,946,939,3180250760,078075,E888
3738,MANIACE,CT,3768,1877,1891,4190210221,087057,M283
3739,MANIAGO,PN,11555,5676,5879,1060930250,093025,E889
3740,MANOCALZATI,AV,3051,1527,1524,3150080460,064046,E891
3741,MANOPPELLO,PE,6771,3307,3464,3130600220,068022,E892
3742,MANSUE',TV,4967,2522,2445,1050840360,026037,E893
3743,MANTA,CN,3765,1856,1909,1010271160,004116,E894
3744,MANTELLO,SO,753,365,388,1030770390,014039,E896
3745,MANTOVA,MN,48441,22916,25525,1030450300,020030,E897
3746,MANZANO,UD,6238,3012,3226,1060850550,030055,E899
3747,MANZIANA,RM,7735,3763,3972,2120700530,058054,E900
3748,MAPELLO,BG,6878,3491,3387,1030121260,016132,E901
3749,MAPPANO,TO,7369,3652,3717,1010811415,001316,M316
3750,MARA,SS,526,253,273,4200730380,090038,E902
3751,MARACALAGONIS,CA,7909,4036,3873,4200170370,092037,E903
3752,MARANELLO,MO,17270,8647,8623,1080500190,036019,E904
3753,MARANO DI NAPOLI,,58042,28208,29834,3150510410,063041,E906
3754,MARANO DI VALPOLICELLA,VR,3115,1552,1563,1050890460,023046,E911
3755,MARANO EQUO,RM,784,400,384,2120700540,058055,E908
3756,MARANO LAGUNARE,UD,1756,879,877,1060850560,030056,E910
3757,MARANO MARCHESATO,CS,3333,1635,1698,3180250770,078076,E914
3758,MARANO PRINCIPATO,CS,3063,1519,1544,3180250780,078077,E915
3759,MARANO SUL PANARO,MO,5323,2645,2678,1080500200,036020,E905
3760,MARANO TICINO,NO,1568,779,789,1010520860,003091,E907
3761,MARANO VICENTINO,VI,9351,4696,4655,1050900560,024056,E912
3762,MARANZANA,AT,230,128,102,1010070610,005061,E917
3763,MARATEA,PZ,4817,2369,2448,3170640430,076044,E919
3764,MARCALLO CON CASONE,MI,6186,3053,3133,1030491330,015134,E921
3765,MARCARIA,MN,6363,3157,3206,1030450310,020031,E922
3766,MARCEDUSA,CZ,395,204,191,3180220690,079071,E923
3767,MARCELLINA,RM,7090,3578,3512,2120700550,058056,E924
3768,MARCELLINARA,CZ,2182,1068,1114,3180220700,079072,E925
3769,MARCETELLI,RI,69,35,34,2120690340,057036,E927
3770,MARCHENO,BS,4196,2114,2082,1030150970,017104,E928
3771,MARCHIROLO,VA,3512,1702,1810,1030860821,012097,E929
3772,MARCIANA,LI,2030,983,1047,2090420100,049010,E930
3773,MARCIANA MARINA,LI,1876,929,947,2090420110,049011,E931
3774,MARCIANISE,CE,38523,18823,19700,3150200490,061049,E932
3775,MARCIANO DELLA CHIANA,AR,3458,1677,1781,2090050220,051022,E933
3776,MARCIGNAGO,PV,2426,1212,1214,1030570830,018086,E934
3777,MARCON,VE,17558,8768,8790,1050870200,027020,E936
3778,MAREBBE/ENNEBERG,BZ,3159,1597,1562,1040140440,021047,E938
3779,MARENE,CN,3269,1610,1659,1010271170,004117,E939
3780,MARENO DI PIAVE,TV,9548,4768,4780,1050840370,026038,E940
3781,MARENTINO,TO,1300,663,637,1010811420,001144,E941
3782,MARETTO,AT,380,200,180,1010070620,005062,E944
3783,MARGARITA,CN,1429,697,732,1010271180,004118,E945
3784,MARGHERITA DI SAVOIA,BT,11262,5521,5741,3161060050,110005,E946
3785,MARGNO,LC,375,198,177,1030980470,097047,E947
3786,MARIANA MANTOVANA,MN,804,395,409,1030450320,020032,E949
3787,MARIANO COMENSE,CO,25182,12387,12795,1030241370,013143,E951
3788,MARIANO DEL FRIULI,GO,1464,728,736,1060350100,031010,E952
3789,MARIANOPOLI,CL,1642,790,852,4190180080,085008,E953
3790,MARIGLIANELLA,,7832,3891,3941,3150510420,063042,E954
3791,MARIGLIANO,,29166,14014,15152,3150510430,063043,E955
3792,MARINA DI GIOIOSA IONICA,RC,6304,3034,3270,3180670450,080045,E956
3793,MARINEO,PA,6214,3054,3160,4190550440,082046,E957
3794,MARINO,RM,46048,22486,23562,2120700560,058057,E958
3795,MARLENGO/MARLING,BZ,2838,1445,1393,1040140450,021048,E959
3796,MARLIANA,PT,3149,1594,1555,2090630070,047007,E960
3797,MARMENTINO,BS,665,339,326,1030150971,017105,E961
3798,MARMIROLO,MN,7625,3752,3873,1030450330,020033,E962
3799,MARMORA,CN,54,29,25,1010271190,004119,E963
3800,MARNATE,VA,8032,3982,4050,1030860830,012098,E965
3801,MARONE,BS,3114,1507,1607,1030150980,017106,E967
3802,MAROPATI,RC,1385,689,696,3180670460,080046,E968
3803,MAROSTICA,VI,13966,6948,7018,1050900570,024057,E970
3804,MARRADI,FI,2891,1468,1423,2090300260,048026,E971
3805,MARRUBIU,OR,4643,2365,2278,4200950250,095025,E972
3806,MARSAGLIA,CN,214,110,104,1010271200,004120,E973
3807,MARSALA,TP,80474,39692,40782,4190820120,081011,E974
3808,MARSCIANO,PG,18038,8802,9236,2100580270,054027,E975
3809,MARSICO NUOVO,PZ,3870,1875,1995,3170640440,076045,E976
3810,MARSICOVETERE,PZ,5556,2759,2797,3170640450,076046,E977
3811,MARTA,VT,3271,1562,1709,2120910330,056034,E978
3812,MARTANO,LE,8620,4154,4466,3160410390,075040,E979
3813,MARTELLAGO,VE,21279,10369,10910,1050870210,027021,E980
3814,MARTELLO/MARTELL,BZ,828,455,373,1040140460,021049,E981
3815,MARTIGNACCO,UD,6847,3297,3550,1060850570,030057,E982
3816,MARTIGNANA DI PO,CR,2045,1021,1024,1030260560,019057,E983
3817,MARTIGNANO,LE,1586,782,804,3160410400,075041,E984
3818,MARTINA FRANCA,TA,47301,22853,24448,3160780130,073013,E986
3819,MARTINENGO,BG,10733,5473,5260,1030121280,016133,E987
3820,MARTINIANA PO,CN,752,425,327,1010271210,004121,E988
3821,MARTINSICURO,TE,16219,7996,8223,3130790251,067047,E989
3822,MARTIRANO,CZ,854,430,424,3180220701,079073,E990
3823,MARTIRANO LOMBARDO,CZ,980,481,499,3180220710,079074,E991
3824,MARTIS,SS,470,234,236,4200730390,090039,E992
3825,MARTONE,RC,503,248,255,3180670470,080047,E993
3826,MARUDO,LO,1769,904,865,1030990360,098036,E994
3827,MARUGGIO,TA,5288,2636,2652,3160780140,073014,E995
3828,MARZABOTTO,BO,6806,3392,3414,1080130360,037036,B689
3829,MARZANO,PV,1684,866,818,1030570840,018087,E999
3830,MARZANO APPIO,CE,2013,1014,999,3150200500,061050,E998
3831,MARZANO DI NOLA,AV,1624,793,831,3150080470,064047,E997
3832,MARZI,CS,964,492,472,3180250790,078078,F001
3833,MARZIO,VA,310,164,146,1030860840,012099,F002
3834,MASAINAS,SU,1227,595,632,4201110400,111040,M270
3835,MASATE,MI,3671,1838,1833,1030491350,015136,F003
3836,MASCALI,CT,14287,7029,7258,4190210230,087023,F004
3837,MASCALUCIA,CT,31998,15608,16390,4190210240,087024,F005
3838,MASCHITO,PZ,1506,734,772,3170640460,076047,F006
3839,MASCIAGO PRIMO,VA,303,154,149,1030860850,012100,F007
3840,MASER,TV,5125,2540,2585,1050840380,026039,F009
3841,MASERA,VB,1476,728,748,1011020420,103042,F010
3842,MASERA' DI PADOVA,PD,9092,4545,4547,1050540480,028048,F011
3843,MASERADA SUL PIAVE,TV,9225,4593,4632,1050840390,026040,F012
3844,MASI,PD,1780,868,912,1050540490,028049,F013
3845,MASI TORELLO,FE,2291,1082,1209,1080290111,038012,F016
3846,MASIO,AL,1278,661,617,1010020890,006091,F015
3847,MASLIANICO,CO,3131,1536,1595,1030241380,013144,F017
3848,MASONE,GE,3443,1685,1758,1070340320,010032,F020
3849,MASSA,MS,66498,32150,34348,2090460100,045010,F023
3850,MASSA D'ALBE,AQ,1365,700,665,3130380540,066054,F022
3851,MASSA DI SOMMA,,5056,2476,2580,3150510431,063092,M289
3852,MASSA E COZZILE,PT,7698,3669,4029,2090630080,047008,F025
3853,MASSA FERMANA,FM,878,420,458,2111050110,109011,F021
3854,MASSA LOMBARDA,RA,10590,5297,5293,1080660130,039013,F029
3855,MASSA LUBRENSE,,14146,6955,7191,3150510440,063044,F030
3856,MASSA MARITTIMA,GR,8124,3884,4240,2090360140,053015,F032
3857,MASSA MARTANA,PG,3641,1846,1795,2100580280,054028,F024
3858,MASSAFRA,TA,32116,15864,16252,3160780150,073015,F027
3859,MASSALENGO,LO,4379,2235,2144,1030990370,098037,F028
3860,MASSANZAGO,PD,6043,3061,2982,1050540500,028050,F033
3861,MASSAROSA,LU,21823,10682,11141,2090430180,046018,F035
3862,MASSAZZA,BI,569,296,273,1010960310,096031,F037
3863,MASSELLO,TO,57,30,27,1010811430,001145,F041
3864,MASSERANO,BI,1916,938,978,1010960320,096032,F042
3865,MASSIGNANO,AP,1635,823,812,2110060290,044029,F044
3866,MASSIMENO,TN,144,79,65,1040831060,022112,F045
3867,MASSIMINO,SV,97,49,48,1070740370,009037,F046
3868,MASSINO VISCONTI,NO,1124,554,570,1010520880,003093,F047
3869,MASSIOLA,VB,117,64,53,1011020430,103043,F048
3870,MASULLAS,OR,1012,527,485,4200950260,095026,F050
3871,MATELICA,MC,9290,4491,4799,2110440240,043024,F051
3872,MATERA,MT,59748,29111,30637,3170470140,077014,F052
3873,MATHI,TO,3777,1880,1897,1010811440,001146,F053
3874,MATINO,LE,10993,5327,5666,3160410410,075042,F054
3875,MATRICE,CB,1056,521,535,3140190370,070037,F055
3876,MATTIE,TO,658,325,333,1010811450,001147,F058
3877,MATTINATA,FG,6031,2962,3069,3160310291,071031,F059
3878,MAZARA DEL VALLO,TP,50312,24906,25406,4190820130,081012,F061
3879,MAZZANO,BS,12519,6258,6261,1030150990,017107,F063
3880,MAZZANO ROMANO,RM,2969,1486,1483,2120700570,058058,F064
3881,MAZZARINO,CL,11086,5297,5789,4190180090,085009,F065
3882,MAZZARRA' SANT'ANDREA,ME,1400,720,680,4190480450,083046,F066
3883,MAZZARRONE,CT,3955,1971,1984,4190210241,087056,M271
3884,MAZZE',TO,4181,2048,2133,1010811460,001148,F067
3885,MAZZIN,TN,588,291,297,1040831070,022113,F068
3886,MAZZO DI VALTELLINA,SO,1028,514,514,1030770400,014040,F070
3887,MEANA DI SUSA,TO,805,413,392,1010811470,001149,F074
3888,MEANA SARDO,NU,1624,808,816,4200530450,091047,F073
3889,MEDA,MB,23350,11491,11859,1031040300,108030,F078
3890,MEDE,PV,6211,2982,3229,1030570850,018088,F080
3891,MEDEA,GO,949,472,477,1060350101,031011,F081
3892,MEDESANO,PR,10693,5322,5371,1080560200,034020,F082
3893,MEDICINA,BO,16646,8170,8476,1080130370,037037,F083
3894,MEDIGLIA,MI,12293,6130,6163,1030491380,015139,F084
3895,MEDOLAGO,BG,2345,1180,1165,1030121281,016250,F085
3896,MEDOLE,MN,4096,2061,2035,1030450340,020034,F086
3897,MEDOLLA,MO,6352,3100,3252,1080500210,036021,F087
3898,MEDUNA DI LIVENZA,TV,2947,1469,1478,1050840400,026041,F088
3899,MEDUNO,PN,1504,753,751,1060930260,093026,F089
3900,MEGLIADINO SAN VITALE,PD,1819,916,903,1050540520,028052,F092
3901,MEINA,NO,2372,1101,1271,1010520890,003095,F093
3902,MELARA,RO,1702,819,883,1050710320,029032,F095
3903,MELAZZO,AL,1258,625,633,1010020900,006092,F096
3904,MELDOLA,FC,9881,4876,5005,1080320180,040019,F097
3905,MELE,GE,2592,1270,1322,1070340330,010033,F098
3906,MELEGNANO,MI,17972,8578,9394,1030491390,015140,F100
3907,MELENDUGNO,LE,9996,4887,5109,3160410420,075043,F101
3908,MELETI,LO,445,217,228,1030990380,098038,F102
3909,MELFI,PZ,17109,8433,8676,3170640470,076048,F104
3910,MELICUCCA',RC,854,405,449,3180670480,080048,F105
3911,MELICUCCO,RC,4889,2421,2468,3180670490,080049,F106
3912,MELILLI,SR,13227,6726,6501,4190760120,089012,F107
3913,MELISSA,KR,3274,1612,1662,3180970140,101014,F108
3914,MELISSANO,LE,6771,3257,3514,3160410430,075044,F109
3915,MELITO DI NAPOLI,,36456,17933,18523,3150510450,063045,F111
3916,MELITO DI PORTO SALVO,RC,10577,5183,5394,3180670500,080050,F112
3917,MELITO IRPINO,AV,1797,906,891,3150080480,064048,F110
3918,MELIZZANO,BN,1712,865,847,3150110380,062039,F113
3919,MELLE,CN,298,161,137,1010271220,004122,F114
3920,MELLO,SO,928,477,451,1030770410,014041,F115
3921,MELPIGNANO,LE,2126,1027,1099,3160410440,075045,F117
3922,MELTINA/MOLTEN,BZ,1705,884,821,1040140470,021050,F118
3923,MELZO,MI,18503,8916,9587,1030491410,015142,F119
3924,MENAGGIO,CO,3035,1508,1527,1030241390,013145,F120
3925,MENCONICO,PV,352,184,168,1030570860,018089,F122
3926,MENDATICA,IM,162,95,67,1070370310,008034,F123
3927,MENDICINO,CS,9208,4620,4588,3180250800,078079,F125
3928,MENFI,AG,11929,5792,6137,4190010230,084023,F126
3929,MENTANA,RM,22643,11151,11492,2120700580,058059,F127
3930,MEOLO,VE,6229,3124,3105,1050870220,027022,F130
3931,MERANA,AL,185,93,92,1010020910,006093,F131
3932,MERANO/MERAN,BZ,40759,19687,21072,1040140480,021051,F132
3933,MERATE,LC,14661,7049,7612,1030980480,097048,F133
3934,MERCALLO,VA,1797,896,901,1030860860,012101,F134
3935,MERCATELLO SUL METAURO,PU,1317,655,662,2110590250,041025,F135
3936,MERCATINO CONCA,PU,1005,504,501,2110590260,041026,F136
3937,MERCATO SAN SEVERINO,SA,21679,10599,11080,3150720670,065067,F138
3938,MERCATO SARACENO,FC,6812,3441,3371,1080320190,040020,F139
3939,MERCENASCO,TO,1291,677,614,1010811480,001150,F140
3940,MERCOGLIANO,AV,11635,5647,5988,3150080490,064049,F141
3941,MERETO DI TOMBA,UD,2530,1266,1264,1060850580,030058,F144
3942,MERGO,AN,1001,490,511,2110030240,042024,F145
3943,MERGOZZO,VB,2156,1065,1091,1011020440,103044,F146
3944,MERI',ME,2322,1137,1185,4190480460,083047,F147
3945,MERLARA,PD,2522,1220,1302,1050540530,028053,F148
3946,MERLINO,LO,1726,889,837,1030990390,098039,F149
3947,MERONE,CO,4058,2019,2039,1030241410,013147,F151
3948,MESAGNE,BR,26114,12521,13593,3160160100,074010,F152
3949,MESE,SO,1824,906,918,1030770430,014043,F153
3950,MESENZANA,VA,1656,813,843,1030860861,012102,F154
3951,MESERO,MI,4191,2103,2088,1030491430,015144,F155
3952,MESOLA,FE,6511,3214,3297,1080290130,038014,F156
3953,MESORACA,KR,5908,2869,3039,3180970150,101015,F157
3954,MESSINA,ME,221246,106126,115120,4190480470,083048,F158
3955,MESTRINO,PD,11655,5735,5920,1050540540,028054,F161
3956,META,,7862,3778,4084,3150510460,063046,F162
3957,MEZZAGO,MB,4470,2238,2232,1031040310,108031,F165
3958,MEZZANA,TN,882,437,445,1040831080,022114,F168
3959,MEZZANA BIGLI,PV,1051,516,535,1030570870,018090,F170
3960,MEZZANA MORTIGLIENGO,BI,495,240,255,1010960330,096033,F167
3961,MEZZANA RABATTONE,PV,467,231,236,1030570880,018091,F171
3962,MEZZANE DI SOTTO,VR,2541,1243,1298,1050890470,023047,F172
3963,MEZZANEGO,GE,1483,751,732,1070340340,010034,F173
3964,MEZZANINO,PV,1320,667,653,1030570890,018092,F175
3965,MEZZANO,TN,1596,802,794,1040831090,022115,F176
3966,MEZZENILE,TO,736,379,357,1010811500,001152,F182
3967,MEZZOCORONA,TN,5508,2706,2802,1040831100,022116,F183
3968,MEZZOJUSO,PA,2682,1320,1362,4190550450,082047,F184
3969,MEZZOLDO,BG,164,83,81,1030121290,016134,F186
3970,MEZZOLOMBARDO,TN,7445,3679,3766,1040831110,022117,F187
3971,MEZZOMERICO,NO,1203,609,594,1010520910,003097,F188
3972,MIAGLIANO,BI,548,256,292,1010960340,096034,F189
3973,MIANE,TV,3144,1552,1592,1050840410,026042,F190
3974,MIASINO,NO,811,370,441,1010520920,003098,F191
3975,MIAZZINA,VB,368,199,169,1011020450,103045,F192
3976,MICIGLIANO,RI,115,65,50,2120690350,057037,F193
3977,MIGGIANO,LE,3296,1543,1753,3160410450,075046,F194
3978,MIGLIANICO,CH,4640,2298,2342,3130230500,069050,F196
3979,MIGLIERINA,CZ,731,334,397,3180220740,079077,F200
3980,MIGLIONICO,MT,2350,1205,1145,3170470150,077015,F201
3981,MIGNANEGO,GE,3495,1744,1751,1070340350,010035,F202
3982,MIGNANO MONTE LUNGO,CE,2999,1465,1534,3150200510,061051,F203
3983,MILANO,MI,1349930,652373,697557,1030491450,015146,F205
3984,MILAZZO,ME,30397,14767,15630,4190480480,083049,F206
3985,MILENA,CL,2731,1325,1406,4190180100,085010,E618
3986,MILETO,VV,6415,3206,3209,3181030210,102021,F207
3987,MILIS,OR,1433,726,707,4200950270,095027,F208
3988,MILITELLO IN VAL DI CATANIA,CT,6796,3368,3428,4190210250,087025,F209
3989,MILITELLO ROSMARINO,ME,1174,588,586,4190480490,083050,F210
3990,MILLESIMO,SV,3212,1565,1647,1070740380,009038,F213
3991,MILO,CT,1038,530,508,4190210251,087026,F214
3992,MILZANO,BS,1723,870,853,1030151000,017108,F216
3993,MINEO,CT,4607,2267,2340,4190210260,087027,F217
3994,MINERBE,VR,4534,2258,2276,1050890480,023048,F218
3995,MINERBIO,BO,8854,4360,4494,1080130380,037038,F219
3996,MINERVINO DI LECCE,LE,3500,1653,1847,3160410460,075047,F221
3997,MINERVINO MURGE,BT,8298,4077,4221,3161060060,110006,F220
3998,MINORI,SA,2596,1291,1305,3150720680,065068,F223
3999,MINTURNO,LT,20215,9988,10227,2120400140,059014,F224
4000,MINUCCIANO,LU,1826,895,931,2090430190,046019,F225
4001,MIOGLIA,SV,490,237,253,1070740390,009039,F226
4002,MIRA,VE,37576,18366,19210,1050870230,027023,F229
4003,MIRABELLA ECLANO,AV,6732,3325,3407,3150080500,064050,F230
4004,MIRABELLA IMBACCARI,CT,4280,2022,2258,4190210270,087028,F231
4005,MIRABELLO MONFERRATO,AL,1211,599,612,1010020920,006094,F232
4006,MIRABELLO SANNITICO,CB,2037,1014,1023,3140190380,070038,F233
4007,MIRADOLO TERME,PV,3677,1863,1814,1030570900,018093,F238
4008,MIRANDA,IS,957,474,483,3140940270,094027,F239
4009,MIRANDOLA,MO,24135,11790,12345,1080500220,036022,F240
4010,MIRANO,VE,27183,13187,13996,1050870240,027024,F241
4011,MIRTO,ME,906,439,467,4190480500,083051,F242
4012,MISANO ADRIATICO,RN,13913,6882,7031,1081010050,099005,F244
4013,MISANO DI GERA D'ADDA,BG,2944,1468,1476,1030121300,016135,F243
4014,MISILISCEMI,TP,8415,4250,4165,4190820135,081025,M432
4015,MISILMERI,PA,28894,14327,14567,4190550460,082048,F246
4016,MISINTO,MB,5664,2829,2835,1031040320,108032,F247
4017,MISSAGLIA,LC,8767,4348,4419,1030980490,097049,F248
4018,MISSANELLO,PZ,483,235,248,3170640480,076049,F249
4019,MISTERBIANCO,CT,49294,24087,25207,4190210280,087029,F250
4020,MISTRETTA,ME,4388,2044,2344,4190480510,083052,F251
4021,MOASCA,AT,514,270,244,1010070630,005063,F254
4022,MOCONESI,GE,2437,1234,1203,1070340360,010036,F256
4023,MODENA,MO,184971,89497,95474,1080500230,036023,F257
4024,MODICA,RG,53554,25907,27647,4190650060,088006,F258
4025,MODIGLIANA,FC,4326,2143,2183,1080320210,040022,F259
4026,MODOLO,OR,155,74,81,4200950276,095084,F261
4027,MODUGNO,BA,36539,17787,18752,3160090270,072027,F262
4028,MOENA,TN,2589,1263,1326,1040831120,022118,F263
4029,MOGGIO,LC,473,229,244,1030980500,097050,F265
4030,MOGGIO UDINESE,UD,1621,799,822,1060850590,030059,F266
4031,MOGLIA,MN,5353,2659,2694,1030450350,020035,F267
4032,MOGLIANO,MC,4372,2141,2231,2110440250,043025,F268
4033,MOGLIANO VENETO,TV,27626,13532,14094,1050840420,026043,F269
4034,MOGORELLA,OR,412,209,203,4200950280,095028,F270
4035,MOGORO,OR,3959,1974,1985,4200950290,095029,F272
4036,MOIANO,BN,4052,1995,2057,3150110390,062040,F274
4037,MOIMACCO,UD,1632,821,811,1060850600,030060,F275
4038,MOIO ALCANTARA,ME,685,332,353,4190480520,083053,F277
4039,MOIO DE' CALVI,BG,195,97,98,1030121301,016136,F276
4040,MOIO DELLA CIVITELLA,SA,1802,875,927,3150720690,065069,F278
4041,MOIOLA,CN,218,116,102,1010271230,004123,F279
4042,MOLA DI BARI,BA,24625,12135,12490,3160090280,072028,F280
4043,MOLARE,AL,2013,958,1055,1010020930,006095,F281
4044,MOLAZZANA,LU,1010,492,518,2090430200,046020,F283
4045,MOLFETTA,BA,57645,28013,29632,3160090290,072029,F284
4046,MOLINA ATERNO,AQ,354,178,176,3130380550,066055,M255
4047,MOLINARA,BN,1471,716,755,3150110400,062041,F287
4048,MOLINELLA,BO,15630,7626,8004,1080130390,037039,F288
4049,MOLINI DI TRIORA,IM,622,332,290,1070370320,008035,F290
4050,MOLINO DEI TORTI,AL,565,304,261,1010020940,006096,F293
4051,MOLISE,CB,158,85,73,3140190390,070039,F294
4052,MOLITERNO,PZ,3631,1734,1897,3170640490,076050,F295
4053,MOLLIA,VC,93,49,44,1010880770,002078,F297
4054,MOLOCHIO,RC,2262,1094,1168,3180670510,080051,F301
4055,MOLTENO,LC,3534,1770,1764,1030980510,097051,F304
4056,MOLTRASIO,CO,1544,732,812,1030241460,013152,F305
4057,MOLVENO,TN,1097,532,565,1040831140,022120,F307
4058,MOMBALDONE,AT,193,105,88,1010070640,005064,F308
4059,MOMBARCARO,CN,250,123,127,1010271240,004124,F309
4060,MOMBAROCCIO,PU,2063,1037,1026,2110590270,041027,F310
4061,MOMBARUZZO,AT,986,505,481,1010070650,005065,F311
4062,MOMBASIGLIO,CN,617,295,322,1010271250,004125,F312
4063,MOMBELLO DI TORINO,TO,387,196,191,1010811510,001153,F315
4064,MOMBELLO MONFERRATO,AL,925,443,482,1010020950,006097,F313
4065,MOMBERCELLI,AT,2109,1036,1073,1010070660,005066,F316
4066,MOMO,NO,2393,1145,1248,1010520940,003100,F317
4067,MOMPANTERO,TO,642,301,341,1010811520,001154,F318
4068,MOMPEO,RI,504,248,256,2120690360,057038,F319
4069,MOMPERONE,AL,195,104,91,1010020960,006098,F320
4070,MONACILIONI,CB,479,222,257,3140190400,070040,F322
4071,MONALE,AT,984,478,506,1010070670,005067,F323
4072,MONASTERACE,RC,3311,1654,1657,3180670520,080052,F324
4073,MONASTERO BORMIDA,AT,872,402,470,1010070680,005068,F325
4074,MONASTERO DI LANZO,TO,328,173,155,1010811530,001155,F327
4075,MONASTERO DI VASCO,CN,1259,609,650,1010271260,004126,F326
4076,MONASTEROLO CASOTTO,CN,80,42,38,1010271270,004127,F329
4077,MONASTEROLO DEL CASTELLO,BG,1141,569,572,1030121310,016137,F328
4078,MONASTEROLO DI SAVIGLIANO,CN,1335,662,673,1010271280,004128,F330
4079,MONASTIER DI TREVISO,TV,4429,2198,2231,1050840430,026044,F332
4080,MONASTIR,SU,4469,2210,2259,4201110410,111041,F333
4081,MONCALIERI,TO,56193,27259,28934,1010811540,001156,F335
4082,MONCALVO,AT,2745,1310,1435,1010070690,005069,F336
4083,MONCENISIO,TO,41,20,21,1010811550,001157,D553
4084,MONCESTINO,AL,196,93,103,1010020970,006099,F337
4085,MONCHIERO,CN,585,299,286,1010271290,004129,F338
4086,MONCHIO DELLE CORTI,PR,837,450,387,1080560220,034022,F340
4087,MONCRIVELLO,VC,1376,689,687,1010880780,002079,F342
4088,MONCUCCO TORINESE,AT,883,437,446,1010070700,005070,F343
4089,MONDAINO,RN,1319,656,663,1081010060,099006,F346
4090,MONDAVIO,PU,3658,1783,1875,2110590280,041028,F347
4091,MONDOLFO,PU,14338,7165,7173,2110590290,041029,F348
4092,MONDOVI',CN,22015,10799,11216,1010271300,004130,F351
4093,MONDRAGONE,CE,28474,14231,14243,3150200520,061052,F352
4094,MONEGLIA,GE,2589,1227,1362,1070340370,010037,F354
4095,MONESIGLIO,CN,595,276,319,1010271310,004131,F355
4096,MONFALCONE,GO,29072,14916,14156,1060350110,031012,F356
4097,MONFORTE D'ALBA,CN,1954,969,985,1010271320,004132,F358
4098,MONFORTE SAN GIORGIO,ME,2547,1230,1317,4190480530,083054,F359
4099,MONFUMO,TV,1315,656,659,1050840440,026045,F360
4100,MONGARDINO,AT,863,431,432,1010070710,005071,F361
4101,MONGHIDORO,BO,3751,1936,1815,1080130400,037040,F363
4102,MONGIANA,VV,650,329,321,3181030220,102022,F364
4103,MONGIARDINO LIGURE,AL,154,82,72,1010020980,006100,F365
4104,MONGIUFFI MELIA,ME,537,272,265,4190480540,083055,F368
4105,MONGRANDO,BI,3667,1774,1893,1010960350,096035,F369
4106,MONGRASSANO,CS,1479,737,742,3180250810,078080,F370
4107,MONGUELFO-TESIDO/WELSBERG-TAISTEN,BZ,2880,1438,1442,1040140490,021052,F371
4108,MONGUZZO,CO,2367,1185,1182,1030241470,013153,F372
4109,MONIGA DEL GARDA,BS,2603,1271,1332,1030151010,017109,F373
4110,MONLEALE,AL,553,274,279,1010020990,006101,F374
4111,MONNO,BS,515,246,269,1030151020,017110,F375
4112,MONOPOLI,BA,48078,23435,24643,3160090300,072030,F376
4113,MONREALE,PA,38665,19030,19635,4190550470,082049,F377
4114,MONRUPINO,TS,857,434,423,1060920020,032002,F378
4115,MONSAMPIETRO MORICO,FM,621,306,315,2111050120,109012,F379
4116,MONSAMPOLO DEL TRONTO,AP,4449,2215,2234,2110060310,044031,F380
4117,MONSANO,AN,3310,1605,1705,2110030250,042025,F381
4118,MONSELICE,PD,17242,8365,8877,1050540550,028055,F382
4119,MONSERRATO,CA,19118,9132,9986,4200170381,092109,F383
4120,MONSUMMANO TERME,PT,20821,10131,10690,2090630090,047009,F384
4121,MONTA',CN,4684,2260,2424,1010271330,004133,F385
4122,MONTABONE,AT,311,161,150,1010070720,005072,F386
4123,MONTACUTO,AL,251,132,119,1010021000,006102,F387
4124,MONTAFIA,AT,927,481,446,1010070730,005073,F390
4125,MONTAGANO,CB,1008,495,513,3140190410,070041,F391
4126,MONTAGNA IN VALTELLINA,SO,2963,1425,1538,1030770440,014044,F393
4127,MONTAGNA SULLA STRADA DEL VINO/MONTAN AN DER WEINSTRASSE,BZ,1690,831,859,1040140500,021053,F392
4128,MONTAGNANA,PD,8898,4335,4563,1050540560,028056,F394
4129,MONTAGNAREALE,ME,1419,707,712,4190480550,083056,F395
4130,MONTAGUTO,AV,350,171,179,3150080510,064051,F397
4131,MONTAIONE,FI,3499,1719,1780,2090300270,048027,F398
4132,MONTALBANO ELICONA,ME,2021,975,1046,4190480560,083057,F400
4133,MONTALBANO JONICO,MT,6796,3347,3449,3170470160,077016,F399
4134,MONTALCINO,SI,5676,2786,2890,2090750141,052037,M378
4135,MONTALDEO,AL,232,108,124,1010021010,006103,F403
4136,MONTALDO BORMIDA,AL,608,309,299,1010021020,006104,F404
4137,MONTALDO DI MONDOVI',CN,530,263,267,1010271340,004134,F405
4138,MONTALDO ROERO,CN,862,423,439,1010271350,004135,F408
4139,MONTALDO SCARAMPI,AT,699,329,370,1010070740,005074,F409
4140,MONTALDO TORINESE,TO,736,359,377,1010811560,001158,F407
4141,MONTALE,PT,10608,5176,5432,2090630100,047010,F410
4142,MONTALENGHE,TO,970,467,503,1010811570,001159,F411
4143,MONTALLEGRO,AG,2394,1170,1224,4190010240,084024,F414
4144,MONTALTO CARPASIO,IM,502,256,246,1070370325,008068,M387
4145,MONTALTO DELLE MARCHE,AP,1939,901,1038,2110060320,044032,F415
4146,MONTALTO DI CASTRO,VT,8795,4387,4408,2120910340,056035,F419
4147,MONTALTO DORA,TO,3304,1612,1692,1010811580,001160,F420
4148,MONTALTO PAVESE,PV,860,439,421,1030570910,018094,F417
4149,MONTALTO UFFUGO,CS,20159,9855,10304,3180250820,078081,F416
4150,MONTANARO,TO,5118,2514,2604,1010811590,001161,F422
4151,MONTANASO LOMBARDO,LO,2234,1100,1134,1030990400,098040,F423
4152,MONTANERA,CN,714,365,349,1010271360,004136,F424
4153,MONTANO ANTILIA,SA,1731,839,892,3150720700,065070,F426
4154,MONTANO LUCINO,CO,5340,2625,2715,1030241480,013154,F427
4155,MONTAPPONE,FM,1584,768,816,2111050130,109013,F428
4156,MONTAQUILA,IS,2303,1165,1138,3140940280,094028,F429
4157,MONTASOLA,RI,404,216,188,2120690370,057039,F430
4158,MONTAURO,CZ,1771,858,913,3180220770,079080,F432
4159,MONTAZZOLI,CH,859,429,430,3130230510,069051,F433
4160,MONTE ARGENTARIO,GR,12040,5865,6175,2090360150,053016,F437
4161,MONTE CASTELLO DI VIBIO,PG,1450,729,721,2100580290,054029,F456
4162,MONTE CAVALLO,MC,104,53,51,2110440270,043027,F460
4163,MONTE CERIGNONE,PU,620,293,327,2110590310,041031,F467
4164,MONTE COMPATRI,RM,11899,5874,6025,2120700590,058060,F477
4165,MONTE CREMASCO,CR,2241,1105,1136,1030260570,019058,F434
4166,MONTE DI MALO,VI,2797,1422,1375,1050900630,024063,F486
4167,MONTE DI PROCIDA,,11929,5784,6145,3150510470,063047,F488
4168,MONTE GIBERTO,FM,738,369,369,2111050160,109016,F517
4169,MONTE GRIMANO TERME,PU,1066,528,538,2110590350,041035,F524
4170,MONTE ISOLA,BS,1628,810,818,1030151030,017111,F532
4171,MONTE MARENZO,LC,1868,928,940,1030980520,097052,F561
4172,MONTE PORZIO,PU,2752,1368,1384,2110590380,041038,F589
4173,MONTE PORZIO CATONE,RM,8584,4133,4451,2120700630,058064,F590
4174,MONTE RINALDO,FM,324,162,162,2111050210,109021,F599
4175,MONTE ROBERTO,AN,3018,1499,1519,2110030290,042029,F600
4176,MONTE ROMANO,VT,1915,951,964,2120910360,056037,F603
4177,MONTE SAN BIAGIO,LT,6104,3088,3016,2120400150,059015,F616
4178,MONTE SAN GIACOMO,SA,1436,702,734,3150720750,065075,F618
4179,MONTE SAN GIOVANNI CAMPANO,FR,12139,6056,6083,2120330440,060044,F620
4180,MONTE SAN GIOVANNI IN SABINA,RI,655,326,329,2120690410,057043,F619
4181,MONTE SAN GIUSTO,MC,7530,3739,3791,2110440310,043031,F621
4182,MONTE SAN MARTINO,MC,709,362,347,2110440320,043032,F622
4183,MONTE SAN PIETRANGELI,FM,2293,1127,1166,2111050230,109023,F626
4184,MONTE SAN PIETRO,BO,10764,5309,5455,1080130420,037042,F627
4185,MONTE SAN SAVINO,AR,8615,4184,4431,2090050250,051025,F628
4186,MONTE SAN VITO,AN,6728,3304,3424,2110030300,042030,F634
4187,MONTE SANT'ANGELO,FG,11508,5617,5891,3160310310,071033,F631
4188,MONTE SANTA MARIA TIBERINA,PG,1112,556,556,2100580320,054032,F629
4189,MONTE URANO,FM,7887,3938,3949,2111050240,109024,F653
4190,MONTE VIDON COMBATTE,FM,400,187,213,2111050250,109025,F664
4191,MONTE VIDON CORRADO,FM,683,347,336,2111050260,109026,F665
4192,MONTEBELLO DELLA BATTAGLIA,PV,1467,732,735,1030570920,018095,F440
4193,MONTEBELLO DI BERTONA,PE,883,448,435,3130600230,068023,F441
4194,MONTEBELLO JONICO,RC,5721,2811,2910,3180670530,080053,D746
4195,MONTEBELLO SUL SANGRO,CH,74,28,46,3130230511,069009,B268
4196,MONTEBELLO VICENTINO,VI,6319,3184,3135,1050900600,024060,F442
4197,MONTEBELLUNA,TV,31062,15199,15863,1050840450,026046,F443
4198,MONTEBRUNO,GE,207,108,99,1070340380,010038,F445
4199,MONTEBUONO,RI,835,417,418,2120690380,057040,F446
4200,MONTECALVO IN FOGLIA,PU,2698,1308,1390,2110590300,041030,F450
4201,MONTECALVO IRPINO,AV,3380,1636,1744,3150080520,064052,F448
4202,MONTECALVO VERSIGGIA,PV,516,259,257,1030570930,018096,F449
4203,MONTECARLO,LU,4366,2110,2256,2090430210,046021,F452
4204,MONTECAROTTO,AN,1860,904,956,2110030260,042026,F453
4205,MONTECASSIANO,MC,6878,3403,3475,2110440260,043026,F454
4206,MONTECASTELLO,AL,290,143,147,1010021021,006105,F455
4207,MONTECASTRILLI,TR,4820,2358,2462,2100800170,055017,F457
4208,MONTECATINI VAL DI CECINA,PI,1669,829,840,2090620190,050019,F458
4209,MONTECATINI-TERME,PT,20468,9652,10816,2090630110,047011,A561
4210,MONTECCHIA DI CROSARA,VR,4218,2182,2036,1050890490,023049,F461
4211,MONTECCHIO,TR,1559,780,779,2100800180,055018,F462
4212,MONTECCHIO EMILIA,RE,10384,5022,5362,1080680270,035027,F463
4213,MONTECCHIO MAGGIORE,VI,23216,11841,11375,1050900610,024061,F464
4214,MONTECCHIO PRECALCINO,VI,4907,2441,2466,1050900620,024062,F465
4215,MONTECHIARO D'ACQUI,AL,501,260,241,1010021030,006106,F469
4216,MONTECHIARO D'ASTI,AT,1206,580,626,1010070750,005075,F468
4217,MONTECHIARUGOLO,PR,11154,5594,5560,1080560230,034023,F473
4218,MONTECILFONE,CB,1204,593,611,3140190420,070042,F475
4219,MONTECOPIOLO,RN,1035,522,513,1081010072,099030,F478
4220,MONTECORICE,SA,2553,1309,1244,3150720710,065071,F479
4221,MONTECORVINO PUGLIANO,SA,11108,5611,5497,3150720720,065072,F480
4222,MONTECORVINO ROVELLA,SA,12318,6202,6116,3150720730,065073,F481
4223,MONTECOSARO,MC,7303,3619,3684,2110440280,043028,F482
4224,MONTECRESTESE,VB,1273,622,651,1011020460,103046,F483
4225,MONTECRETO,MO,919,480,439,1080500240,036024,F484
4226,MONTEDINOVE,AP,472,264,208,2110060340,044034,F487
4227,MONTEDORO,CL,1419,672,747,4190180110,085011,F489
4228,MONTEFALCIONE,AV,3141,1529,1612,3150080530,064053,F491
4229,MONTEFALCO,PG,5421,2673,2748,2100580300,054030,F492
4230,MONTEFALCONE APPENNINO,FM,375,189,186,2111050140,109014,F493
4231,MONTEFALCONE DI VAL FORTORE,BN,1335,618,717,3150110410,062042,F494
4232,MONTEFALCONE NEL SANNIO,CB,1399,704,695,3140190430,070043,F495
4233,MONTEFANO,MC,3302,1621,1681,2110440290,043029,F496
4234,MONTEFELCINO,PU,2509,1270,1239,2110590340,041034,F497
4235,MONTEFERRANTE,CH,111,58,53,3130230520,069052,F498
4236,MONTEFIASCONE,VT,13020,6316,6704,2120910350,056036,F499
4237,MONTEFINO,TE,967,481,486,3130790260,067027,F500
4238,MONTEFIORE CONCA,RN,2237,1112,1125,1081010080,099008,F502
4239,MONTEFIORE DELL'ASO,AP,1980,960,1020,2110060360,044036,F501
4240,MONTEFIORINO,MO,2085,1050,1035,1080500250,036025,F503
4241,MONTEFLAVIO,RM,1195,557,638,2120700600,058061,F504
4242,MONTEFORTE CILENTO,SA,539,280,259,3150720740,065074,F507
4243,MONTEFORTE D'ALPONE,VR,9006,4607,4399,1050890500,023050,F508
4244,MONTEFORTE IRPINO,AV,11428,5768,5660,3150080540,064054,F506
4245,MONTEFORTINO,FM,1077,539,538,2111050150,109015,F509
4246,MONTEFRANCO,TR,1263,628,635,2100800190,055019,F510
4247,MONTEFREDANE,AV,2134,1066,1068,3150080550,064055,F511
4248,MONTEFUSCO,AV,1212,606,606,3150080560,064056,F512
4249,MONTEGABBIONE,TR,1120,551,569,2100800200,055020,F513
4250,MONTEGALDA,VI,3376,1669,1707,1050900640,024064,F514
4251,MONTEGALDELLA,VI,1785,893,892,1050900650,024065,F515
4252,MONTEGALLO,AP,448,236,212,2110060380,044038,F516
4253,MONTEGIOCO,AL,284,151,133,1010021040,006107,F518
4254,MONTEGIORDANO,CS,1595,769,826,3180250830,078082,F519
4255,MONTEGIORGIO,FM,6407,3147,3260,2111050170,109017,F520
4256,MONTEGRANARO,FM,12497,6246,6251,2111050180,109018,F522
4257,MONTEGRIDOLFO,RN,991,501,490,1081010090,099009,F523
4258,MONTEGRINO VALTRAVAGLIA,VA,1491,738,753,1030860870,012103,F526
4259,MONTEGROSSO D'ASTI,AT,2290,1157,1133,1010070760,005076,F527
4260,MONTEGROSSO PIAN LATTE,IM,120,58,62,1070370340,008037,F528
4261,MONTEGROTTO TERME,PD,11362,5462,5900,1050540570,028057,F529
4262,MONTEIASI,TA,5377,2595,2782,3160780160,073016,F531
4263,MONTELABBATE,PU,7006,3548,3458,2110590360,041036,F533
4264,MONTELANICO,RM,2066,1022,1044,2120700610,058062,F534
4265,MONTELAPIANO,CH,77,36,41,3130230530,069053,F535
4266,MONTELEONE D'ORVIETO,TR,1369,645,724,2100800210,055021,F543
4267,MONTELEONE DI FERMO,FM,357,190,167,2111050190,109019,F536
4268,MONTELEONE DI PUGLIA,FG,959,495,464,3160310300,071032,F538
4269,MONTELEONE DI SPOLETO,PG,567,287,280,2100580310,054031,F540
4270,MONTELEONE ROCCA DORIA,SS,111,49,62,4200730400,090040,F542
4271,MONTELEONE SABINO,RI,1197,593,604,2120690390,057041,F541
4272,MONTELEPRE,PA,5857,2838,3019,4190550480,082050,F544
4273,MONTELIBRETTI,RM,5140,2459,2681,2120700620,058063,F545
4274,MONTELLA,AV,7367,3582,3785,3150080570,064057,F546
4275,MONTELLO,BG,3176,1636,1540,1030121311,016139,F547
4276,MONTELONGO,CB,315,162,153,3140190440,070044,F548
4277,MONTELPARO,FM,713,361,352,2111050200,109020,F549
4278,MONTELUPO ALBESE,CN,480,231,249,1010271370,004137,F550
4279,MONTELUPO FIORENTINO,FI,14226,6887,7339,2090300280,048028,F551
4280,MONTELUPONE,MC,3392,1685,1707,2110440300,043030,F552
4281,MONTEMAGGIORE BELSITO,PA,2990,1435,1555,4190550490,082051,F553
4282,MONTEMAGNO MONFERRATO,AT,1053,498,555,1010070770,005077,F556
4283,MONTEMALE DI CUNEO,CN,214,107,107,1010271380,004138,F558
4284,MONTEMARANO,AV,2636,1306,1330,3150080580,064058,F559
4285,MONTEMARCIANO,AN,9754,4835,4919,2110030270,042027,F560
4286,MONTEMARZINO,AL,311,158,153,1010021050,006108,F562
4287,MONTEMESOLA,TA,3608,1760,1848,3160780170,073017,F563
4288,MONTEMEZZO,CO,220,115,105,1030241490,013155,F564
4289,MONTEMIGNAIO,AR,523,265,258,2090050230,051023,F565
4290,MONTEMILETTO,AV,5067,2521,2546,3150080590,064059,F566
4291,MONTEMILONE,PZ,1402,703,699,3170640500,076051,F568
4292,MONTEMITRO,CB,299,149,150,3140190450,070045,F569
4293,MONTEMONACO,AP,528,262,266,2110060440,044044,F570
4294,MONTEMURLO,PO,19100,9442,9658,2091000030,100003,F572
4295,MONTEMURRO,PZ,1120,539,581,3170640510,076052,F573
4296,MONTENARS,UD,483,247,236,1060850610,030061,F574
4297,MONTENERO DI BISACCIA,CB,6191,3094,3097,3140190460,070046,F576
4298,MONTENERO SABINO,RI,280,145,135,2120690400,057042,F579
4299,MONTENERO VAL COCCHIARA,IS,503,263,240,3140940290,094029,F580
4300,MONTENERODOMO,CH,604,314,290,3130230540,069054,F578
4301,MONTEODORISIO,CH,2348,1173,1175,3130230550,069055,F582
4302,MONTEPAONE,CZ,5614,2798,2816,3180220780,079081,F586
4303,MONTEPARANO,TA,2315,1116,1199,3160780180,073018,F587
4304,MONTEPRANDONE,AP,12869,6411,6458,2110060450,044045,F591
4305,MONTEPULCIANO,SI,13386,6415,6971,2090750150,052015,F592
4306,MONTERCHI,AR,1708,846,862,2090050240,051024,F594
4307,MONTEREALE,AQ,2200,1135,1065,3130380560,066056,F595
4308,MONTEREALE VALCELLINA,PN,4267,2060,2207,1060930270,093027,F596
4309,MONTERENZIO,BO,6161,3108,3053,1080130410,037041,F597
4310,MONTERIGGIONI,SI,9993,4933,5060,2090750160,052016,F598
4311,MONTERODUNI,IS,2037,983,1054,3140940300,094030,F601
4312,MONTERONI D'ARBIA,SI,8984,4398,4586,2090750170,052017,F605
4313,MONTERONI DI LECCE,LE,13425,6524,6901,3160410470,075048,F604
4314,MONTEROSI,VT,4775,2370,2405,2120910370,056038,F606
4315,MONTEROSSO AL MARE,SP,1371,637,734,1070390190,011019,F609
4316,MONTEROSSO ALMO,RG,2821,1376,1445,4190650070,088007,F610
4317,MONTEROSSO CALABRO,VV,1548,758,790,3181030230,102023,F607
4318,MONTEROSSO GRANA,CN,514,279,235,1010271390,004139,F608
4319,MONTEROTONDO,RM,41060,19906,21154,2120700640,058065,F611
4320,MONTEROTONDO MARITTIMO,GR,1283,681,602,2090360151,053027,F612
4321,MONTERUBBIANO,FM,2041,998,1043,2111050220,109022,F614
4322,MONTESANO SALENTINO,LE,2599,1266,1333,3160410480,075049,F623
4323,MONTESANO SULLA MARCELLANA,SA,6275,3098,3177,3150720760,065076,F625
4324,MONTESARCHIO,BN,13001,6354,6647,3150110420,062043,F636
4325,MONTESCAGLIOSO,MT,9247,4577,4670,3170470170,077017,F637
4326,MONTESCANO,PV,416,201,215,1030570940,018097,F638
4327,MONTESCHENO,VB,380,194,186,1011020470,103047,F639
4328,MONTESCUDAIO,PI,2167,1077,1090,2090620200,050020,F640
4329,MONTESCUDO - MONTE COLOMBO,RN,6782,3431,3351,1081010101,099029,M368
4330,MONTESE,MO,3222,1610,1612,1080500260,036026,F642
4331,MONTESEGALE,PV,263,139,124,1030570950,018098,F644
4332,MONTESILVANO,PE,53402,25975,27427,3130600240,068024,F646
4333,MONTESPERTOLI,FI,13236,6572,6664,2090300300,048030,F648
4334,MONTEU DA PO,TO,858,429,429,1010811600,001162,F651
4335,MONTEU ROERO,CN,1634,838,796,1010271400,004140,F654
4336,MONTEVAGO,AG,2743,1350,1393,4190010250,084025,F655
4337,MONTEVARCHI,AR,24047,11881,12166,2090050260,051026,F656
4338,MONTEVECCHIA,LC,2677,1334,1343,1030980530,097053,F657
4339,MONTEVERDE,AV,714,357,357,3150080600,064060,F660
4340,MONTEVERDI MARITTIMO,PI,753,384,369,2090620210,050021,F661
4341,MONTEVIALE,VI,2801,1396,1405,1050900660,024066,F662
4342,MONTEZEMOLO,CN,225,124,101,1010271410,004141,F666
4343,MONTI,SS,2348,1188,1160,4200730410,090041,F667
4344,MONTIANO,FC,1683,839,844,1080320270,040028,F668
4345,MONTICELLI BRUSATI,BS,4568,2301,2267,1030151040,017112,F672
4346,MONTICELLI D'ONGINA,PC,5106,2515,2591,1080610270,033027,F671
4347,MONTICELLI PAVESE,PV,631,309,322,1030570960,018099,F670
4348,MONTICELLO BRIANZA,LC,4153,2054,2099,1030980540,097054,F674
4349,MONTICELLO CONTE OTTO,VI,8983,4432,4551,1050900670,024067,F675
4350,MONTICELLO D'ALBA,CN,2351,1158,1193,1010271420,004142,F669
4351,MONTICHIARI,BS,26088,13081,13007,1030151050,017113,F471
4352,MONTICIANO,SI,1534,779,755,2090750180,052018,F676
4353,MONTIERI,GR,1173,609,564,2090360160,053017,F677
4354,MONTIGLIO MONFERRATO,AT,1516,752,764,1010070781,005121,M302
4355,MONTIGNOSO,MS,10122,4976,5146,2090460110,045011,F679
4356,MONTIRONE,BS,5064,2573,2491,1030151051,017114,F680
4357,MONTJOVET,AO,1766,891,875,1020040420,007043,F367
4358,MONTODINE,CR,2441,1206,1235,1030260580,019059,F681
4359,MONTOGGIO,GE,2008,1015,993,1070340390,010039,F682
4360,MONTONE,PG,1579,755,824,2100580330,054033,F685
4361,MONTOPOLI DI SABINA,RI,4103,2034,2069,2120690420,057044,F687
4362,MONTOPOLI IN VAL D'ARNO,PI,11109,5504,5605,2090620220,050022,F686
4363,MONTORFANO,CO,2516,1211,1305,1030241510,013157,F688
4364,MONTORIO AL VOMANO,TE,7528,3731,3797,3130790270,067028,F690
4365,MONTORIO NEI FRENTANI,CB,366,185,181,3140190470,070047,F689
4366,MONTORIO ROMANO,RM,1939,984,955,2120700650,058066,F692
4367,MONTORO,AV,19396,9695,9701,3150080605,064121,M330
4368,MONTORSO VICENTINO,VI,3031,1562,1469,1050900680,024068,F696
4369,MONTOTTONE,FM,878,415,463,2111050270,109027,F697
4370,MONTRESTA,OR,440,222,218,4200950296,095085,F698
4371,MONTU' BECCARIA,PV,1618,823,795,1030570970,018100,F701
4372,MONVALLE,VA,1939,972,967,1030860880,012104,F703
4373,MONZA,MB,121984,58584,63400,1031040330,108033,F704
4374,MONZAMBANO,MN,4859,2425,2434,1030450360,020036,F705
4375,MONZUNO,BO,6358,3210,3148,1080130440,037044,F706
4376,MORANO CALABRO,CS,3944,1942,2002,3180250840,078083,F708
4377,MORANO SUL PO,AL,1319,640,679,1010021060,006109,F707
4378,MORANSENGO-TONENGO,AT,397,199,198,1010070792,005122,M434
4379,MORARO,GO,695,349,346,1060350111,031013,F710
4380,MORAZZONE,VA,4278,2103,2175,1030860890,012105,F711
4381,MORBEGNO,SO,12227,5941,6286,1030770450,014045,F712
4382,MORBELLO,AL,389,203,186,1010021070,006110,F713
4383,MORCIANO DI LEUCA,LE,3049,1417,1632,3160410490,075050,F716
4384,MORCIANO DI ROMAGNA,RN,7139,3462,3677,1081010110,099011,F715
4385,MORCONE,BN,4548,2231,2317,3150110430,062044,F717
4386,MORDANO,BO,4591,2343,2248,1080130450,037045,F718
4387,MORENGO,BG,2488,1224,1264,1030121330,016140,F720
4388,MORES,SS,1758,877,881,4200730420,090042,F721
4389,MORESCO,FM,524,252,272,2111050280,109028,F722
4390,MORETTA,CN,4078,2029,2049,1010271430,004143,F723
4391,MORFASSO,PC,888,456,432,1080610280,033028,F724
4392,MORGANO,TV,4428,2220,2208,1050840460,026047,F725
4393,MORGEX,AO,2058,1006,1052,1020040430,007044,F726
4394,MORGONGIORI,OR,661,339,322,4200950300,095030,F727
4395,MORI,TN,10048,4997,5051,1040831160,022123,F728
4396,MORIAGO DELLA BATTAGLIA,TV,2783,1401,1382,1050840470,026048,F729
4397,MORICONE,RM,2469,1222,1247,2120700660,058067,F730
4398,MORIGERATI,SA,610,297,313,3150720770,065077,F731
4399,MORIMONDO,MI,1024,514,510,1030491490,015150,D033
4400,MORINO,AQ,1316,647,669,3130380570,066057,F732
4401,MORIONDO TORINESE,TO,853,434,419,1010811610,001163,F733
4402,MORLUPO,RM,8488,4104,4384,2120700670,058068,F734
4403,MORMANNO,CS,2671,1298,1373,3180250850,078084,F735
4404,MORNAGO,VA,4926,2450,2476,1030860900,012106,F736
4405,MORNESE,AL,710,340,370,1010021080,006111,F737
4406,MORNICO AL SERIO,BG,2914,1428,1486,1030121340,016141,F738
4407,MORNICO LOSANA,PV,590,294,296,1030570980,018101,F739
4408,MOROLO,FR,3182,1618,1564,2120330450,060045,F740
4409,MOROZZO,CN,2000,1008,992,1010271440,004144,F743
4410,MORRA DE SANCTIS,AV,1133,548,585,3150080630,064063,F744
4411,MORRO D'ALBA,AN,1803,888,915,2110030310,042031,F745
4412,MORRO D'ORO,TE,3560,1738,1822,3130790280,067029,F747
4413,MORRO REATINO,RI,328,167,161,2120690430,057045,F746
4414,MORRONE DEL SANNIO,CB,533,274,259,3140190480,070048,F748
4415,MORROVALLE,MC,9882,4934,4948,2110440330,043033,F749
4416,MORSANO AL TAGLIAMENTO,PN,2680,1340,1340,1060930280,093028,F750
4417,MORSASCO,AL,606,292,314,1010021090,006112,F751
4418,MORTARA,PV,15300,7442,7858,1030570990,018102,F754
4419,MORTEGLIANO,UD,4814,2306,2508,1060850620,030062,F756
4420,MORTERONE,LC,31,17,14,1030980550,097055,F758
4421,MORUZZO,UD,2452,1213,1239,1060850630,030063,F760
4422,MOSCAZZANO,CR,714,367,347,1030260590,019060,F761
4423,MOSCHIANO,AV,1553,744,809,3150080631,064064,F762
4424,MOSCIANO SANT'ANGELO,TE,9088,4539,4549,3130790290,067030,F764
4425,MOSCUFO,PE,3092,1566,1526,3130600250,068025,F765
4426,MOSO IN PASSIRIA/MOOS IN PASSEIER,BZ,2046,1085,961,1040140510,021054,F766
4427,MOSSA,GO,1522,727,795,1060350112,031014,F767
4428,MOTTA BALUFFI,CR,796,401,395,1030260600,019061,F771
4429,MOTTA CAMASTRA,ME,811,415,396,4190480570,083058,F772
4430,MOTTA D'AFFERMO,ME,672,330,342,4190480580,083059,F773
4431,MOTTA DE' CONTI,VC,741,373,368,1010880810,002082,F774
4432,MOTTA DI LIVENZA,TV,10661,5227,5434,1050840480,026049,F770
4433,MOTTA MONTECORVINO,FG,655,311,344,3160310320,071034,F777
4434,MOTTA SAN GIOVANNI,RC,5672,2783,2889,3180670540,080054,F779
4435,MOTTA SANT'ANASTASIA,CT,12054,5915,6139,4190210290,087030,F781
4436,MOTTA SANTA LUCIA,CZ,789,396,393,3180220800,079083,F780
4437,MOTTA VISCONTI,MI,8120,3990,4130,1030491500,015151,F783
4438,MOTTAFOLLONE,CS,1094,540,554,3180250860,078085,F775
4439,MOTTALCIATA,BI,1332,673,659,1010960370,096037,F776
4440,MOTTEGGIANA,MN,2458,1281,1177,1030450370,020037,B012
4441,MOTTOLA,TA,15419,7525,7894,3160780190,073019,F784
4442,MOZZAGROGNA,CH,2426,1179,1247,3130230560,069056,F785
4443,MOZZANICA,BG,4349,2187,2162,1030121350,016142,F786
4444,MOZZATE,CO,8677,4295,4382,1030241521,013159,F788
4445,MOZZECANE,VR,8045,4131,3914,1050890510,023051,F789
4446,MOZZO,BG,7311,3591,3720,1030121360,016143,F791
4447,MUCCIA,MC,823,396,427,2110440340,043034,F793
4448,MUGGIA,TS,12916,6256,6660,1060920030,032003,F795
4449,MUGGIO',MB,23513,11525,11988,1031040340,108034,F797
4450,MUGNANO DEL CARDINALE,AV,5145,2605,2540,3150080640,064065,F798
4451,MUGNANO DI NAPOLI,,34578,16797,17781,3150510480,063048,F799
4452,MULAZZANO,LO,5834,2917,2917,1030990410,098041,F801
4453,MULAZZO,MS,2288,1136,1152,2090460120,045012,F802
4454,MURA,BS,774,387,387,1030151060,017115,F806
4455,MURAVERA,SU,5171,2524,2647,4201110420,111042,F808
4456,MURAZZANO,CN,830,413,417,1010271450,004145,F809
4457,MURELLO,CN,937,473,464,1010271460,004146,F811
4458,MURIALDO,SV,773,409,364,1070740400,009040,F813
4459,MURISENGO,AL,1291,627,664,1010021100,006113,F814
4460,MURLO,SI,2408,1237,1171,2090750190,052019,F815
4461,MURO LECCESE,LE,4765,2288,2477,3160410500,075051,F816
4462,MURO LUCANO,PZ,4960,2470,2490,3170640520,076053,F817
4463,MUROS,SS,830,406,424,4200730430,090043,F818
4464,MUSCOLINE,BS,2680,1354,1326,1030151070,017116,F820
4465,MUSEI,SU,1512,785,727,4201110430,111043,F822
4466,MUSILE DI PIAVE,VE,11326,5617,5709,1050870250,027025,F826
4467,MUSSO,CO,934,473,461,1030241530,013160,F828
4468,MUSSOLENTE,VI,7634,3848,3786,1050900700,024070,F829
4469,MUSSOMELI,CL,10011,4837,5174,4190180120,085012,F830
4470,MUZZANA DEL TURGNANO,UD,2360,1159,1201,1060850640,030064,F832
4471,MUZZANO,BI,578,269,309,1010960380,096038,F833
4472,NAGO-TORBOLE,TN,2822,1386,1436,1040831161,022124,F835
4473,NALLES/NALS,BZ,2075,1028,1047,1040140520,021055,F836
4474,NANTO,VI,3105,1581,1524,1050900710,024071,F838
4475,NAPOLI,,921142,442655,478487,3150510490,063049,F839
4476,NARBOLIA,OR,1692,830,862,4200950310,095031,F840
4477,NARCAO,SU,3105,1570,1535,4201110440,111044,F841
4478,NARDO',LE,30790,14712,16078,3160410510,075052,F842
4479,NARDODIPACE,VV,1115,559,556,3181030240,102024,F843
4480,NARNI,TR,18258,8828,9430,2100800220,055022,F844
4481,NARO,AG,7051,3418,3633,4190010260,084026,F845
4482,NARZOLE,CN,3493,1748,1745,1010271470,004147,F846
4483,NASINO,SV,174,91,83,1070740410,009041,F847
4484,NASO,ME,3513,1696,1817,4190480590,083060,F848
4485,NATURNO/NATURNS,BZ,6015,3017,2998,1040140530,021056,F849
4486,NAVE,BS,10640,5262,5378,1030151080,017117,F851
4487,NAVELLI,AQ,499,270,229,3130380580,066058,F852
4488,NAZ-SCIAVES/NATZ-SCHABS,BZ,3281,1639,1642,1040140540,021057,F856
4489,NAZZANO,RM,1367,704,663,2120700680,058069,F857
4490,NE,GE,2130,1085,1045,1070340400,010040,F858
4491,NEBBIUNO,NO,1788,888,900,1010520970,003103,F859
4492,NEGRAR DI VALPOLICELLA,VR,16651,8274,8377,1050890520,023052,F861
4493,NEIRONE,GE,843,455,388,1070340410,010041,F862
4494,NEIVE,CN,3328,1619,1709,1010271480,004148,F863
4495,NEMBRO,BG,11222,5563,5659,1030121370,016144,F864
4496,NEMI,RM,1890,950,940,2120700690,058070,F865
4497,NEMOLI,PZ,1404,682,722,3170640530,076054,F866
4498,NEONELI,OR,622,296,326,4200950320,095032,F867
4499,NEPI,VT,9318,4608,4710,2120910380,056039,F868
4500,NERETO,TE,5274,2577,2697,3130790300,067031,F870
4501,NEROLA,RM,1897,937,960,2120700700,058071,F871
4502,NERVESA DELLA BATTAGLIA,TV,6543,3275,3268,1050840490,026050,F872
4503,NERVIANO,MI,16928,8261,8667,1030491530,015154,F874
4504,NESPOLO,RI,191,116,75,2120690440,057046,F876
4505,NESSO,CO,1163,575,588,1030241540,013161,F877
4506,NETRO,BI,939,469,470,1010960390,096039,F878
4507,NETTUNO,RM,48159,23886,24273,2120700710,058072,F880
4508,NEVIANO,LE,4954,2370,2584,3160410520,075053,F881
4509,NEVIANO DEGLI ARDUINI,PR,3428,1730,1698,1080560240,034024,F882
4510,NEVIGLIE,CN,367,187,180,1010271490,004149,F883
4511,NIARDO,BS,1968,963,1005,1030151090,017118,F884
4512,NIBBIOLA,NO,825,403,422,1010520980,003104,F886
4513,NIBIONNO,LC,3600,1782,1818,1030980560,097056,F887
4514,NICHELINO,TO,46458,22455,24003,1010811620,001164,F889
4515,NICOLOSI,CT,7596,3789,3807,4190210300,087031,F890
4516,NICORVO,PV,277,136,141,1030571000,018103,F891
4517,NICOSIA,EN,12877,6261,6616,4190280120,086012,F892
4518,NICOTERA,VV,5835,2977,2858,3181030250,102025,F893
4519,NIELLA BELBO,CN,347,181,166,1010271500,004150,F894
4520,NIELLA TANARO,CN,956,491,465,1010271510,004151,F895
4521,NIMIS,UD,2558,1278,1280,1060850650,030065,F898
4522,NISCEMI,CL,25179,12465,12714,4190180130,085013,F899
4523,NISSORIA,EN,2861,1446,1415,4190280130,086013,F900
4524,NIZZA DI SICILIA,ME,3543,1738,1805,4190480600,083061,F901
4525,NIZZA MONFERRATO,AT,10094,4875,5219,1010070800,005080,F902
4526,NOALE,VE,16128,7803,8325,1050870260,027026,F904
4527,NOASCA,TO,107,56,51,1010811630,001165,F906
4528,NOCARA,CS,325,158,167,3180250870,078086,F907
4529,NOCCIANO,PE,1725,869,856,3130600260,068026,F908
4530,NOCERA INFERIORE,SA,44331,21577,22754,3150720780,065078,F912
4531,NOCERA SUPERIORE,SA,23842,11727,12115,3150720790,065079,F913
4532,NOCERA TERINESE,CZ,4719,2378,2341,3180220840,079087,F910
4533,NOCERA UMBRA,PG,5584,2761,2823,2100580340,054034,F911
4534,NOCETO,PR,13115,6426,6689,1080560250,034025,F914
4535,NOCI,BA,18444,8946,9498,3160090310,072031,F915
4536,NOCIGLIA,LE,2159,1008,1151,3160410530,075054,F916
4537,NOEPOLI,PZ,766,367,399,3170640540,076055,F917
4538,NOGARA,VR,8343,4140,4203,1050890530,023053,F918
4539,NOGAREDO,TN,2055,1046,1009,1040831181,022127,F920
4540,NOGAROLE ROCCA,VR,3835,2017,1818,1050890540,023054,F921
4541,NOGAROLE VICENTINO,VI,1219,617,602,1050900720,024072,F922
4542,NOICATTARO,BA,26016,12902,13114,3160090320,072032,F923
4543,NOLA,,33619,16312,17307,3150510500,063050,F924
4544,NOLE,TO,6803,3332,3471,1010811640,001166,F925
4545,NOLI,SV,2442,1170,1272,1070740420,009042,F926
4546,NOMAGLIO,TO,283,141,142,1010811641,001167,F927
4547,NOMI,TN,1302,626,676,1040831190,022128,F929
4548,NONANTOLA,MO,16022,7951,8071,1080500270,036027,F930
4549,NONE,TO,7830,3876,3954,1010811650,001168,F931
4550,NONIO,VB,844,402,442,1011020480,103048,F932
4551,NORAGUGUME,NU,286,141,145,4200530480,091050,F933
4552,NORBELLO,OR,1141,594,547,4200950330,095033,F934
4553,NORCIA,PG,4556,2303,2253,2100580350,054035,F935
4554,NORMA,LT,3675,1776,1899,2120400160,059016,F937
4555,NOSATE,MI,636,307,329,1030491540,015155,F939
4556,NOTARESCO,TE,6387,3150,3237,3130790310,067032,F942
4557,NOTO,SR,23905,12037,11868,4190760130,089013,F943
4558,NOVA LEVANTE/WELSCHNOFEN,BZ,2023,1050,973,1040140550,021058,F949
4559,NOVA MILANESE,MB,23070,11297,11773,1031040350,108035,F944
4560,NOVA PONENTE/DEUTSCHNOFEN,BZ,4016,2052,1964,1040140560,021059,F950
4561,NOVA SIRI,MT,6708,3382,3326,3170470180,077018,A942
4562,NOVAFELTRIA,RN,6962,3450,3512,1081010115,099023,F137
4563,NOVALEDO,TN,1101,526,575,1040831200,022129,F947
4564,NOVALESA,TO,516,260,256,1010811660,001169,F948
4565,NOVARA,NO,101367,49080,52287,1010521000,003106,F952
4566,NOVARA DI SICILIA,ME,1186,580,606,4190480610,083062,F951
4567,NOVATE MEZZOLA,SO,1883,923,960,1030770460,014046,F956
4568,NOVATE MILANESE,MI,19877,9530,10347,1030491560,015157,F955
4569,NOVE,VI,4894,2398,2496,1050900730,024073,F957
4570,NOVEDRATE,CO,2880,1464,1416,1030241560,013163,F958
4571,NOVELLA,TN,3581,1822,1759,1040831196,022253,M430
4572,NOVELLARA,RE,13337,6587,6750,1080680280,035028,F960
4573,NOVELLO,CN,960,474,486,1010271520,004152,F961
4574,NOVENTA DI PIAVE,VE,6952,3433,3519,1050870270,027027,F963
4575,NOVENTA PADOVANA,PD,11524,5693,5831,1050540580,028058,F962
4576,NOVENTA VICENTINA,VI,8929,4479,4450,1050900740,024074,F964
4577,NOVI DI MODENA,MO,10001,4998,5003,1080500280,036028,F966
4578,NOVI LIGURE,AL,27449,13217,14232,1010021110,006114,F965
4579,NOVI VELIA,SA,2312,1176,1136,3150720800,065080,F967
4580,NOVIGLIO,MI,4528,2282,2246,1030491570,015158,F968
4581,NOVOLI,LE,7639,3637,4002,3160410540,075055,F970
4582,NUCETTO,CN,393,197,196,1010271530,004153,F972
4583,NUGHEDU SAN NICOLO',SS,763,383,380,4200730440,090044,F975
4584,NUGHEDU SANTA VITTORIA,OR,441,210,231,4200950340,095034,F974
4585,NULE,SS,1293,655,638,4200730450,090045,F976
4586,NULVI,SS,2648,1307,1341,4200730460,090046,F977
4587,NUMANA,AN,3757,1890,1867,2110030320,042032,F978
4588,NUORO,NU,34183,16266,17917,4200530490,091051,F979
4589,NURACHI,OR,1692,822,870,4200950350,095035,F980
4590,NURAGUS,SU,842,416,426,4201110450,111045,F981
4591,NURALLAO,SU,1178,606,572,4201110460,111046,F982
4592,NURAMINIS,SU,2339,1154,1185,4201110470,111047,F983
4593,NURECI,OR,320,158,162,4200950360,095036,F985
4594,NURRI,SU,2034,1030,1004,4201110480,111048,F986
4595,NUS,AO,2988,1486,1502,1020040440,007045,F987
4596,NUSCO,AV,3918,1905,2013,3150080650,064066,F988
4597,NUVOLENTO,BS,3865,1897,1968,1030151100,017119,F989
4598,NUVOLERA,BS,4695,2340,2355,1030151110,017120,F990
4599,NUXIS,SU,1455,713,742,4201110490,111049,F991
4600,OCCHIEPPO INFERIORE,BI,3753,1795,1958,1010960400,096040,F992
4601,OCCHIEPPO SUPERIORE,BI,2638,1261,1377,1010960410,096041,F993
4602,OCCHIOBELLO,RO,12002,5840,6162,1050710330,029033,F994
4603,OCCIMIANO,AL,1242,590,652,1010021120,006115,F995
4604,OCRE,AQ,1099,554,545,3130380590,066059,F996
4605,ODALENGO GRANDE,AL,407,207,200,1010021130,006116,F997
4606,ODALENGO PICCOLO,AL,239,124,115,1010021140,006117,F998
4607,ODERZO,TV,20042,9723,10319,1050840500,026051,F999
4608,ODOLO,BS,1927,931,996,1030151120,017121,G001
4609,OFENA,AQ,428,212,216,3130380600,066060,G002
4610,OFFAGNA,AN,2037,1031,1006,2110030330,042033,G003
4611,OFFANENGO,CR,5927,2929,2998,1030260610,019062,G004
4612,OFFIDA,AP,4702,2294,2408,2110060540,044054,G005
4613,OFFLAGA,BS,4117,2095,2022,1030151130,017122,G006
4614,OGGEBBIO,VB,854,418,436,1011020490,103049,G007
4615,OGGIONA CON SANTO STEFANO,VA,4319,2156,2163,1030860910,012107,G008
4616,OGGIONO,LC,9043,4473,4570,1030980570,097057,G009
4617,OGLIANICO,TO,1455,713,742,1010811670,001170,G010
4618,OGLIASTRO CILENTO,SA,2263,1151,1112,3150720810,065081,G011
4619,OLBIA,SS,60711,29997,30714,4200730470,090047,G015
4620,OLCENENGO,VC,787,385,402,1010880870,002088,G016
4621,OLDENICO,VC,217,108,109,1010880880,002089,G018
4622,OLEGGIO,NO,14204,6970,7234,1010521020,003108,G019
4623,OLEGGIO CASTELLO,NO,2203,1107,1096,1010521030,003109,G020
4624,OLEVANO DI LOMELLINA,PV,723,347,376,1030571010,018104,G021
4625,OLEVANO ROMANO,RM,6404,3191,3213,2120700720,058073,G022
4626,OLEVANO SUL TUSCIANO,SA,6536,3237,3299,3150720820,065082,G023
4627,OLGIATE COMASCO,CO,11780,5769,6011,1030241590,013165,G025
4628,OLGIATE MOLGORA,LC,6346,3150,3196,1030980580,097058,G026
4629,OLGIATE OLONA,VA,12599,6146,6453,1030860920,012108,G028
4630,OLGINATE,LC,6938,3445,3493,1030980590,097059,G030
4631,OLIENA,NU,6657,3271,3386,4200530530,091055,G031
4632,OLIVA GESSI,PV,170,78,92,1030571020,018105,G032
4633,OLIVADI,CZ,482,233,249,3180220850,079088,G034
4634,OLIVERI,ME,2048,989,1059,4190480620,083063,G036
4635,OLIVETO CITRA,SA,3650,1799,1851,3150720830,065083,G039
4636,OLIVETO LARIO,LC,1199,609,590,1030980600,097060,G040
4637,OLIVETO LUCANO,MT,366,172,194,3170470190,077019,G037
4638,OLIVETTA SAN MICHELE,IM,201,100,101,1070370350,008038,G041
4639,OLIVOLA,AL,114,54,60,1010021150,006118,G042
4640,OLLASTRA,OR,1144,569,575,4200950370,095037,G043
4641,OLLOLAI,NU,1202,599,603,4200530540,091056,G044
4642,OLLOMONT,AO,158,84,74,1020040450,007046,G045
4643,OLMEDO,SS,4134,2081,2053,4200730480,090048,G046
4644,OLMENETA,CR,905,433,472,1030260620,019063,G047
4645,OLMO AL BREMBO,BG,486,245,241,1030121390,016145,G049
4646,OLMO GENTILE,AT,70,35,35,1010070810,005081,G048
4647,OLTRE IL COLLE,BG,980,508,472,1030121400,016146,G050
4648,OLTRESSENDA ALTA,BG,144,76,68,1030121401,016147,G054
4649,OLTRONA DI SAN MAMETTE,CO,2373,1182,1191,1030241620,013169,G056
4650,OLZAI,NU,774,391,383,4200530550,091057,G058
4651,OME,BS,3152,1537,1615,1030151140,017123,G061
4652,OMEGNA,VB,14503,7037,7466,1011020500,103050,G062
4653,OMIGNANO,SA,1632,811,821,3150720840,065084,G063
4654,ONANI',NU,373,181,192,4200530560,091058,G064
4655,ONANO,VT,912,442,470,2120910390,056040,G065
4656,ONCINO,CN,87,50,37,1010271540,004154,G066
4657,ONETA,BG,571,283,288,1030121410,016148,G068
4658,ONIFAI,NU,697,335,362,4200530570,091059,G070
4659,ONIFERI,NU,873,439,434,4200530580,091060,G071
4660,ONO SAN PIETRO,BS,965,477,488,1030151150,017124,G074
4661,ONORE,BG,920,452,468,1030121411,016149,G075
4662,ONZO,SV,219,103,116,1070740430,009043,G076
4663,OPERA,MI,14152,6788,7364,1030491580,015159,G078
4664,OPI,AQ,374,192,182,3130380610,066061,G079
4665,OPPEANO,VR,10202,5202,5000,1050890550,023055,G080
4666,OPPIDO LUCANO,PZ,3616,1804,1812,3170640550,076056,G081
4667,OPPIDO MAMERTINA,RC,4859,2383,2476,3180670550,080055,G082
4668,ORA/AUER,BZ,3859,1898,1961,1040140570,021060,G083
4669,ORANI,NU,2723,1344,1379,4200530590,091061,G084
4670,ORATINO,CB,1625,845,780,3140190490,070049,G086
4671,ORBASSANO,TO,23044,11161,11883,1010811680,001171,G087
4672,ORBETELLO,GR,14352,6862,7490,2090360170,053018,G088
4673,ORCIANO PISANO,PI,633,301,332,2090620221,050023,G090
4674,ORCO FEGLINO,SV,919,471,448,1070740440,009044,D522
4675,ORDONA,FG,2820,1430,1390,3160310321,071063,M266
4676,ORERO,GE,503,255,248,1070340420,010042,G093
4677,ORGIANO,VI,3012,1490,1522,1050900750,024075,G095
4678,ORGOSOLO,NU,3971,1985,1986,4200530600,091062,G097
4679,ORIA,BR,14569,7041,7528,3160160110,074011,G098
4680,ORICOLA,AQ,1251,621,630,3130380620,066062,G102
4681,ORIGGIO,VA,7939,3958,3981,1030860930,012109,G103
4682,ORINO,VA,819,412,407,1030860931,012110,G105
4683,ORIO AL SERIO,BG,1667,842,825,1030121420,016150,G108
4684,ORIO CANAVESE,TO,756,380,376,1010811690,001172,G109
4685,ORIO LITTA,LO,2004,983,1021,1030990420,098042,G107
4686,ORIOLO,CS,1885,883,1002,3180250880,078087,G110
4687,ORIOLO ROMANO,VT,3728,1853,1875,2120910400,056041,G111
4688,ORISTANO,OR,30653,14483,16170,4200950380,095038,G113
4689,ORMEA,CN,1477,767,710,1010271550,004155,G114
4690,ORMELLE,TV,4515,2285,2230,1050840510,026052,G115
4691,ORNAGO,MB,5255,2604,2651,1031040360,108036,G116
4692,ORNAVASSO,VB,3354,1668,1686,1011020510,103051,G117
4693,ORNICA,BG,145,73,72,1030121430,016151,G118
4694,OROSEI,NU,6833,3360,3473,4200530610,091063,G119
4695,OROTELLI,NU,1905,949,956,4200530620,091064,G120
4696,ORRIA,SA,993,498,495,3150720850,065085,G121
4697,ORROLI,SU,2017,1020,997,4201110500,111050,G122
4698,ORSAGO,TV,3850,1906,1944,1050840520,026053,G123
4699,ORSARA BORMIDA,AL,400,198,202,1010021160,006119,G124
4700,ORSARA DI PUGLIA,FG,2521,1256,1265,3160310330,071035,G125
4701,ORSENIGO,CO,2649,1319,1330,1030241630,013170,G126
4702,ORSOGNA,CH,3653,1762,1891,3130230570,069057,G128
4703,ORSOMARSO,CS,1140,565,575,3180250890,078088,G129
4704,ORTA DI ATELLA,CE,27118,13483,13635,3150200530,061053,G130
4705,ORTA NOVA,FG,16869,8360,8509,3160310340,071036,G131
4706,ORTA SAN GIULIO,NO,1131,534,597,1010521060,003112,G134
4707,ORTACESUS,SU,883,461,422,4201110510,111051,G133
4708,ORTE,VT,9055,4484,4571,2120910410,056042,G135
4709,ORTELLE,LE,2234,1063,1171,3160410550,075056,G136
4710,ORTEZZANO,FM,745,368,377,2111050290,109029,G137
4711,ORTIGNANO RAGGIOLO,AR,852,437,415,2090050270,051027,G139
4712,ORTISEI/ST. ULRICH,BZ,4833,2395,2438,1040140580,021061,G140
4713,ORTONA,CH,22305,10852,11453,3130230580,069058,G141
4714,ORTONA DEI MARSI,AQ,434,204,230,3130380630,066063,G142
4715,ORTOVERO,SV,1599,809,790,1070740450,009045,G144
4716,ORTUCCHIO,AQ,1774,904,870,3130380640,066064,G145
4717,ORTUERI,NU,1049,529,520,4200530640,091066,G146
4718,ORUNE,NU,2177,1096,1081,4200530650,091067,G147
4719,ORVIETO,TR,19689,9372,10317,2100800230,055023,G148
4720,ORVINIO,RI,398,208,190,2120690450,057047,B595
4721,ORZINUOVI,BS,12372,6239,6133,1030151160,017125,G149
4722,ORZIVECCHI,BS,2430,1225,1205,1030151170,017126,G150
4723,OSASCO,TO,1153,563,590,1010811700,001173,G151
4724,OSASIO,TO,936,488,448,1010811710,001174,G152
4725,OSCHIRI,SS,3051,1534,1517,4200730490,090049,G153
4726,OSIDDA,NU,219,104,115,4200530660,091068,G154
4727,OSIGLIA,SV,443,229,214,1070740460,009046,G155
4728,OSILO,SS,2834,1391,1443,4200730500,090050,G156
4729,OSIMO,AN,34792,17167,17625,2110030340,042034,G157
4730,OSINI,NU,727,383,344,4200530670,091069,G158
4731,OSIO SOPRA,BG,5211,2582,2629,1030121440,016152,G159
4732,OSIO SOTTO,BG,12487,6270,6217,1030121450,016153,G160
4733,OSNAGO,LC,4742,2312,2430,1030980610,097061,G161
4734,OSOPPO,UD,2826,1402,1424,1060850660,030066,G163
4735,OSPEDALETTI,IM,3168,1510,1658,1070370360,008039,G164
4736,OSPEDALETTO,TN,785,406,379,1040831201,022130,G168
4737,OSPEDALETTO D'ALPINOLO,AV,2063,1011,1052,3150080660,064067,G165
4738,OSPEDALETTO EUGANEO,PD,5543,2764,2779,1050540590,028059,G167
4739,OSPEDALETTO LODIGIANO,LO,1953,1008,945,1030990430,098043,G166
4740,OSPITALE DI CADORE,BL,267,131,136,1050100350,025035,G169
4741,OSPITALETTO,BS,14663,7485,7178,1030151180,017127,G170
4742,OSSAGO LODIGIANO,LO,1415,715,700,1030990440,098044,G171
4743,OSSANA,TN,822,388,434,1040831210,022131,G173
4744,OSSI,SS,5513,2705,2808,4200730510,090051,G178
4745,OSSIMO,BS,1452,724,728,1030151190,017128,G179
4746,OSSONA,MI,4343,2198,2145,1030491630,015164,G181
4747,OSTANA,CN,85,49,36,1010271560,004156,G183
4748,OSTELLATO,FE,5719,2817,2902,1080290150,038017,G184
4749,OSTIANO,CR,2699,1338,1361,1030260630,019064,G185
4750,OSTIGLIA,MN,6583,3216,3367,1030450380,020038,G186
4751,OSTRA,AN,6398,3119,3279,2110030350,042035,F401
4752,OSTRA VETERE,AN,3141,1568,1573,2110030360,042036,F581
4753,OSTUNI,BR,30302,14530,15772,3160160120,074012,G187
4754,OTRANTO,LE,5715,2739,2976,3160410560,075057,G188
4755,OTRICOLI,TR,1724,851,873,2100800240,055024,G189
4756,OTTANA,NU,2199,1093,1106,4200530680,091070,G191
4757,OTTATI,SA,631,313,318,3150720860,065086,G192
4758,OTTAVIANO,,23064,11366,11698,3150510510,063051,G190
4759,OTTIGLIO,AL,594,298,296,1010021170,006120,G193
4760,OTTOBIANO,PV,1073,537,536,1030571030,018106,G194
4761,OTTONE,PC,444,252,192,1080610300,033030,G195
4762,OULX,TO,3293,1687,1606,1010811711,001175,G196
4763,OVADA,AL,10873,5202,5671,1010021180,006121,G197
4764,OVARO,UD,1752,873,879,1060850670,030067,G198
4765,OVIGLIO,AL,1196,594,602,1010021190,006122,G199
4766,OVINDOLI,AQ,1158,587,571,3130380650,066065,G200
4767,OVODDA,NU,1536,773,763,4200530690,091071,G201
4768,OYACE,AO,209,112,97,1020040460,007047,G012
4769,OZEGNA,TO,1176,582,594,1010811720,001176,G202
4770,OZIERI,SS,9935,4941,4994,4200730520,090052,G203
4771,OZZANO DELL'EMILIA,BO,13922,6783,7139,1080130460,037046,G205
4772,OZZANO MONFERRATO,AL,1366,683,683,1010021200,006123,G204
4773,OZZERO,MI,1405,686,719,1030491640,015165,G206
4774,PABILLONIS,SU,2540,1293,1247,4201110520,111052,G207
4775,PACE DEL MELA,ME,6011,2938,3073,4190480630,083064,G209
4776,PACECO,TP,10896,5305,5591,4190820140,081013,G208
4777,PACENTRO,AQ,1105,560,545,3130380660,066066,G210
4778,PACHINO,SR,21678,11004,10674,4190760140,089014,G211
4779,PACIANO,PG,952,464,488,2100580360,054036,G212
4780,PADENGHE SUL GARDA,BS,4773,2313,2460,1030151200,017129,G213
4781,PADERNA,AL,198,101,97,1010021210,006124,G215
4782,PADERNO D'ADDA,LC,3846,1910,1936,1030980620,097062,G218
4783,PADERNO DUGNANO,MI,47090,22880,24210,1030491650,015166,G220
4784,PADERNO FRANCIACORTA,BS,3637,1807,1830,1030151210,017130,G217
4785,PADERNO PONCHIELLI,CR,1345,684,661,1030260640,019065,G222
4786,PADOVA,PD,206651,98507,108144,1050540600,028060,G224
4787,PADRIA,SS,605,299,306,4200730530,090053,G225
4788,PADRU,SS,2055,1047,1008,4200730532,090090,M301
4789,PADULA,SA,4936,2426,2510,3150720870,065087,G226
4790,PADULI,BN,3651,1805,1846,3150110440,062045,G227
4791,PAESANA,CN,2637,1316,1321,1010271570,004157,G228
4792,PAESE,TV,22012,10912,11100,1050840540,026055,G229
4793,PAGANI,SA,34472,16838,17634,3150720880,065088,G230
4794,PAGANICO SABINO,RI,148,77,71,2120690460,057048,G232
4795,PAGAZZANO,BG,2098,1092,1006,1030121460,016154,G233
4796,PAGLIARA,ME,1135,551,584,4190480640,083065,G234
4797,PAGLIETA,CH,4154,2063,2091,3130230590,069059,G237
4798,PAGNACCO,UD,5112,2510,2602,1060850680,030068,G238
4799,PAGNO,CN,584,289,295,1010271580,004158,G240
4800,PAGNONA,LC,328,167,161,1030980630,097063,G241
4801,PAGO DEL VALLO DI LAURO,AV,1741,852,889,3150080670,064068,G242
4802,PAGO VEIANO,BN,2304,1143,1161,3150110450,062046,G243
4803,PAISCO LOVENO,BS,176,87,89,1030151220,017131,G247
4804,PAITONE,BS,2170,1117,1053,1030151230,017132,G248
4805,PALADINA,BG,3976,1973,2003,1030121470,016155,G249
4806,PALAGANO,MO,2059,1014,1045,1080500281,036029,G250
4807,PALAGIANELLO,TA,7627,3694,3933,3160780200,073020,G251
4808,PALAGIANO,TA,15788,7898,7890,3160780210,073021,G252
4809,PALAGONIA,CT,15802,7791,8011,4190210310,087032,G253
4810,PALAIA,PI,4535,2162,2373,2090620230,050024,G254
4811,PALANZANO,PR,1051,554,497,1080560260,034026,G255
4812,PALATA,CB,1575,762,813,3140190500,070050,G257
4813,PALAU,SS,4106,2081,2025,4200730531,090054,G258
4814,PALAZZAGO,BG,4492,2299,2193,1030121480,016156,G259
4815,PALAZZO ADRIANO,PA,1849,875,974,4190550500,082052,G263
4816,PALAZZO CANAVESE,TO,839,404,435,1010811730,001177,G262
4817,PALAZZO PIGNANO,CR,3777,1897,1880,1030260650,019066,G260
4818,PALAZZO SAN GERVASIO,PZ,4511,2285,2226,3170640560,076057,G261
4819,PALAZZOLO ACREIDE,SR,8233,3998,4235,4190760150,089015,G267
4820,PALAZZOLO DELLO STELLA,UD,2891,1419,1472,1060850690,030069,G268
4821,PALAZZOLO SULL'OGLIO,BS,19937,10022,9915,1030151240,017133,G264
4822,PALAZZOLO VERCELLESE,VC,1105,548,557,1010880890,002090,G266
4823,PALAZZUOLO SUL SENIO,FI,1111,567,544,2090300310,048031,G270
4824,PALENA,CH,1251,625,626,3130230600,069060,G271
4825,PALERMITI,CZ,1075,519,556,3180220860,079089,G272
4826,PALERMO,PA,635439,303851,331588,4190550510,082053,G273
4827,PALESTRINA,RM,22082,10880,11202,2120700730,058074,G274
4828,PALESTRO,PV,1785,884,901,1030571040,018107,G275
4829,PALIANO,FR,7951,3937,4014,2120330460,060046,G276
4830,PALIZZI,RC,1993,965,1028,3180670560,080056,G277
4831,PALLAGORIO,KR,1019,509,510,3180970160,101016,G278
4832,PALLANZENO,VB,1102,550,552,1011020520,103052,G280
4833,PALLARE,SV,900,451,449,1070740470,009047,G281
4834,PALMA CAMPANIA,,16223,8535,7688,3150510520,063052,G283
4835,PALMA DI MONTECHIARO,AG,21509,10288,11221,4190010270,084027,G282
4836,PALMANOVA,UD,5288,2592,2696,1060850700,030070,G284
4837,PALMARIGGI,LE,1403,686,717,3160410570,075058,G285
4838,PALMAS ARBOREA,OR,1475,728,747,4200950390,095039,G286
4839,PALMI,RC,17868,8692,9176,3180670570,080057,G288
4840,PALMIANO,AP,163,73,90,2110060560,044056,G289
4841,PALMOLI,CH,804,415,389,3130230610,069061,G290
4842,PALO DEL COLLE,BA,20761,10251,10510,3160090330,072033,G291
4843,PALOMBARA SABINA,RM,12882,6392,6490,2120700740,058075,G293
4844,PALOMBARO,CH,961,473,488,3130230620,069062,G294
4845,PALOMONTE,SA,3754,1891,1863,3150720890,065089,G292
4846,PALOSCO,BG,5747,2872,2875,1030121490,016157,G295
4847,PALU',VR,1216,609,607,1050890551,023056,G297
4848,PALU' DEL FERSINA,TN,167,86,81,1040831230,022133,G296
4849,PALUDI,CS,1014,510,504,3180250900,078089,G298
4850,PALUZZA,UD,1995,990,1005,1060850710,030071,G300
4851,PAMPARATO,CN,270,142,128,1010271590,004159,G302
4852,PANCALIERI,TO,1992,963,1029,1010811740,001178,G303
4853,PANCARANA,PV,315,165,150,1030571050,018108,G304
4854,PANCHIA',TN,809,392,417,1040831240,022134,G305
4855,PANDINO,CR,8908,4438,4470,1030260660,019067,G306
4856,PANETTIERI,CS,316,150,166,3180250910,078090,G307
4857,PANICALE,PG,5332,2591,2741,2100580370,054037,G308
4858,PANNARANO,BN,1989,1033,956,3150110460,062047,G311
4859,PANNI,FG,714,346,368,3160310350,071037,G312
4860,PANTELLERIA,TP,7407,3701,3706,4190820150,081014,G315
4861,PANTIGLIATE,MI,5796,2815,2981,1030491660,015167,G316
4862,PAOLA,CS,14827,7165,7662,3180250920,078091,G317
4863,PAOLISI,BN,2007,1026,981,3150110470,062048,G318
4864,PAPASIDERO,CS,634,325,309,3180250930,078092,G320
4865,PAPOZZE,RO,1355,673,682,1050710340,029034,G323
4866,PARABIAGO,MI,27859,13718,14141,1030491670,015168,G324
4867,PARABITA,LE,8741,4158,4583,3160410580,075059,G325
4868,PARATICO,BS,4884,2443,2441,1030151250,017134,G327
4869,PARCINES/PARTSCHINS,BZ,3887,1927,1960,1040140590,021062,G328
4870,PARELLA,TO,412,190,222,1010811750,001179,G330
4871,PARENTI,CS,2031,1005,1026,3180250940,078093,G331
4872,PARETE,CE,12192,6023,6169,3150200540,061054,G333
4873,PARETO,AL,517,280,237,1010021220,006125,G334
4874,PARGHELIA,VV,1261,612,649,3181030260,102026,G335
4875,PARLASCO,LC,136,70,66,1030980640,097064,G336
4876,PARMA,PR,195436,94586,100850,1080560270,034027,G337
4877,PARODI LIGURE,AL,614,318,296,1010021230,006126,G338
4878,PAROLDO,CN,195,93,102,1010271600,004160,G339
4879,PAROLISE,AV,638,315,323,3150080680,064069,G340
4880,PARONA,PV,1849,935,914,1030571060,018109,G342
4881,PARRANO,TR,485,242,243,2100800250,055025,G344
4882,PARRE,BG,2698,1341,1357,1030121500,016158,G346
4883,PARTANNA,TP,9932,4879,5053,4190820160,081015,G347
4884,PARTINICO,PA,30844,15371,15473,4190550520,082054,G348
4885,PARUZZARO,NO,2143,1049,1094,1010521080,003114,G349
4886,PARZANICA,BG,345,186,159,1030121510,016159,G350
4887,PASIAN DI PRATO,UD,9265,4444,4821,1060850720,030072,G352
4888,PASIANO DI PORDENONE,PN,7760,3861,3899,1060930290,093029,G353
4889,PASPARDO,BS,579,301,278,1030151260,017135,G354
4890,PASSERANO MARMORITO,AT,432,229,203,1010070820,005082,G358
4891,PASSIGNANO SUL TRASIMENO,PG,5662,2733,2929,2100580380,054038,G359
4892,PASSIRANO,BS,6914,3392,3522,1030151270,017136,G361
4893,PASTENA,FR,1284,641,643,2120330470,060047,G362
4894,PASTORANO,CE,2899,1468,1431,3150200550,061055,G364
4895,PASTRENGO,VR,3088,1541,1547,1050890560,023057,G365
4896,PASTURANA,AL,1286,618,668,1010021240,006127,G367
4897,PASTURO,LC,1933,982,951,1030980650,097065,G368
4898,PATERNO,PZ,3069,1479,1590,3170640561,076100,M269
4899,PATERNO CALABRO,CS,1350,696,654,3180250950,078094,G372
4900,PATERNO',CT,45539,22158,23381,4190210320,087033,G371
4901,PATERNOPOLI,AV,2158,1071,1087,3150080690,064070,G370
4902,PATRICA,FR,3071,1518,1553,2120330480,060048,G374
4903,PATTADA,SS,2892,1469,1423,4200730540,090055,G376
4904,PATTI,ME,12802,6126,6676,4190480650,083066,G377
4905,PATU',LE,1688,820,868,3160410590,075060,G378
4906,PAU,OR,276,131,145,4200950400,095040,G379
4907,PAULARO,UD,2373,1194,1179,1060850730,030073,G381
4908,PAULI ARBAREI,SU,564,282,282,4201110530,111053,G382
4909,PAULILATINO,OR,2096,1066,1030,4200950410,095041,G384
4910,PAULLO,MI,11108,5452,5656,1030491680,015169,G385
4911,PAUPISI,BN,1432,710,722,3150110480,062049,G386
4912,PAVAROLO,TO,1148,556,592,1010811760,001180,G387
4913,PAVIA,PV,70380,33627,36753,1030571070,018110,G388
4914,PAVIA DI UDINE,UD,5514,2722,2792,1060850740,030074,G389
4915,PAVONE CANAVESE,TO,3635,1776,1859,1010811770,001181,G392
4916,PAVONE DEL MELLA,BS,2706,1370,1336,1030151280,017137,G391
4917,PAVULLO NEL FRIGNANO,MO,18042,8979,9063,1080500290,036030,G393
4918,PAZZANO,RC,498,249,249,3180670580,080058,G394
4919,PECCIOLI,PI,4666,2233,2433,2090620240,050025,G395
4920,PECETTO DI VALENZA,AL,1166,581,585,1010021250,006128,G397
4921,PECETTO TORINESE,TO,4046,1976,2070,1010811790,001183,G398
4922,PEDARA,CT,14915,7428,7487,4190210330,087034,G402
4923,PEDASO,FM,2811,1341,1470,2111050300,109030,G403
4924,PEDAVENA,BL,4328,2117,2211,1050100360,025036,G404
4925,PEDEMONTE,VI,700,341,359,1050900760,024076,G406
4926,PEDEROBBA,TV,7280,3639,3641,1050840550,026056,G408
4927,PEDESINA,SO,35,19,16,1030770470,014047,G410
4928,PEDIVIGLIANO,CS,744,349,395,3180250970,078096,G411
4929,PEDRENGO,BG,5883,2919,2964,1030121520,016160,G412
4930,PEGLIO,CO,189,92,97,1030241700,013178,G415
4931,PEGLIO,CO,189,92,97,2110590410,041041,G416
4932,PEGLIO,PU,651,325,326,1030241700,013178,G415
4933,PEGLIO,PU,651,325,326,2110590410,041041,G416
4934,PEGOGNAGA,MN,6888,3412,3476,1030450390,020039,G417
4935,PEIA,BG,1720,840,880,1030121530,016161,G418
4936,PEIO,TN,1820,939,881,1040831260,022136,G419
4937,PELAGO,FI,7760,3818,3942,2090300320,048032,G420
4938,PELLA,NO,894,422,472,1010521090,003115,G421
4939,PELLEGRINO PARMENSE,PR,962,475,487,1080560280,034028,G424
4940,PELLEZZANO,SA,10951,5399,5552,3150720900,065090,G426
4941,PELLIZZANO,TN,772,381,391,1040831261,022137,G428
4942,PELUGO,TN,396,190,206,1040831270,022138,G429
4943,PENANGO,AT,445,217,228,1010070830,005083,G430
4944,PENNA IN TEVERINA,TR,1029,506,523,2100800260,055026,G432
4945,PENNA SAN GIOVANNI,MC,971,465,506,2110440350,043035,G436
4946,PENNA SANT'ANDREA,TE,1635,801,834,3130790320,067033,G437
4947,PENNABILLI,RN,2629,1301,1328,1081010116,099024,G433
4948,PENNADOMO,CH,218,105,113,3130230630,069063,G434
4949,PENNAPIEDIMONTE,CH,425,214,211,3130230640,069064,G435
4950,PENNE,PE,11368,5583,5785,3130600270,068027,G438
4951,PENTONE,CZ,1934,931,1003,3180220890,079092,G439
4952,PERANO,CH,1518,748,770,3130230650,069065,G441
4953,PERAROLO DI CADORE,BL,373,180,193,1050100370,025037,G442
4954,PERCA/PERCHA,BZ,1656,834,822,1040140600,021063,G443
4955,PERCILE,RM,215,114,101,2120700750,058076,G444
4956,PERDASDEFOGU,NU,1763,890,873,4200530700,091072,G445
4957,PERDAXIUS,SU,1326,675,651,4201110540,111054,G446
4958,PERDIFUMO,SA,1758,861,897,3150720910,065091,G447
4959,PERETO,AQ,638,327,311,3130380670,066067,G449
4960,PERFUGAS,SS,2272,1132,1140,4200730550,090056,G450
4961,PERGINE VALSUGANA,TN,21483,10457,11026,1040831280,022139,G452
4962,PERGOLA,PU,5830,2809,3021,2110590430,041043,G453
4963,PERINALDO,IM,845,409,436,1070370370,008040,G454
4964,PERITO,SA,829,411,418,3150720920,065092,G455
4965,PERLEDO,LC,864,428,436,1030980670,097067,G456
4966,PERLETTO,CN,260,139,121,1010271610,004161,G457
4967,PERLO,CN,108,56,52,1010271620,004162,G458
4968,PERLOZ,AO,458,225,233,1020040470,007048,G459
4969,PERNUMIA,PD,3766,1889,1877,1050540610,028061,G461
4970,PERO,MI,11477,5681,5796,1030491690,015170,C013
4971,PEROSA ARGENTINA,TO,3094,1473,1621,1010811800,001184,G463
4972,PEROSA CANAVESE,TO,525,253,272,1010811810,001185,G462
4973,PERRERO,TO,583,315,268,1010811820,001186,G465
4974,PERSICO DOSIMO,CR,3279,1637,1642,1030260670,019068,G469
4975,PERTENGO,VC,305,147,158,1010880900,002091,G471
4976,PERTICA ALTA,BS,557,293,264,1030151300,017139,G474
4977,PERTICA BASSA,BS,576,282,294,1030151310,017140,G475
4978,PERTOSA,SA,652,318,334,3150720930,065093,G476
4979,PERTUSIO,TO,752,372,380,1010811830,001187,G477
4980,PERUGIA,PG,162362,77973,84389,2100580390,054039,G478
4981,PESARO,PU,95670,46048,49622,2110590440,041044,G479
4982,PESCAGLIA,LU,3306,1652,1654,2090430220,046022,G480
4983,PESCANTINA,VR,17426,8664,8762,1050890570,023058,G481
4984,PESCARA,PE,118992,56234,62758,3130600280,068028,G482
4985,PESCAROLO ED UNITI,CR,1516,756,760,1030260680,019069,G483
4986,PESCASSEROLI,AQ,2076,1079,997,3130380680,066068,G484
4987,PESCATE,LC,2149,1069,1080,1030980680,097068,G485
4988,PESCHE,IS,1517,756,761,3140940310,094031,G486
4989,PESCHICI,FG,4305,2155,2150,3160310360,071038,G487
4990,PESCHIERA BORROMEO,MI,24084,11812,12272,1030491700,015171,G488
4991,PESCHIERA DEL GARDA,VR,10911,5272,5639,1050890580,023059,G489
4992,PESCIA,PT,19223,9369,9854,2090630120,047012,G491
4993,PESCINA,AQ,3762,1861,1901,3130380690,066069,G492
4994,PESCO SANNITA,BN,1869,890,979,3150110490,062050,G494
4995,PESCOCOSTANZO,AQ,1091,567,524,3130380700,066070,G493
4996,PESCOLANCIANO,IS,810,403,407,3140940320,094032,G495
4997,PESCOPAGANO,PZ,1702,835,867,3170640570,076058,G496
4998,PESCOPENNATARO,IS,233,120,113,3140940330,094033,G497
4999,PESCOROCCHIANO,RI,1928,982,946,2120690470,057049,G498
5000,PESCOSANSONESCO,PE,471,228,243,3130600290,068029,G499
5001,PESCOSOLIDO,FR,1462,738,724,2120330490,060049,G500
5002,PESSANO CON BORNAGO,MI,8983,4448,4535,1030491710,015172,G502
5003,PESSINA CREMONESE,CR,573,295,278,1030260690,019070,G504
5004,PESSINETTO,TO,608,317,291,1010811840,001188,G505
5005,PETACCIATO,CB,3494,1763,1731,3140190510,070051,G506
5006,PETILIA POLICASTRO,KR,8714,4366,4348,3180970170,101017,G508
5007,PETINA,SA,1037,522,515,3150720940,065094,G509
5008,PETRALIA SOPRANA,PA,2992,1473,1519,4190550530,082055,G510
5009,PETRALIA SOTTANA,PA,2492,1156,1336,4190550540,082056,G511
5010,PETRELLA SALTO,RI,1036,564,472,2120690480,057050,G513
5011,PETRELLA TIFERNINA,CB,1044,509,535,3140190520,070052,G512
5012,PETRIANO,PU,2726,1373,1353,2110590450,041045,G514
5013,PETRIOLO,MC,1843,925,918,2110440360,043036,G515
5014,PETRITOLI,FM,2156,1057,1099,2111050310,109031,G516
5015,PETRIZZI,CZ,1028,508,520,3180220910,079094,G517
5016,PETRONA',CZ,2404,1157,1247,3180220920,079095,G518
5017,PETROSINO,TP,7962,4105,3857,4190820161,081024,M281
5018,PETRURO IRPINO,AV,298,149,149,3150080700,064071,G519
5019,PETTENASCO,NO,1341,663,678,1010521100,003116,G520
5020,PETTINENGO,BI,1470,743,727,1010960420,096042,G521
5021,PETTINEO,ME,1235,598,637,4190480660,083067,G522
5022,PETTORANELLO DEL MOLISE,IS,449,247,202,3140940340,094034,G523
5023,PETTORANO SUL GIZIO,AQ,1324,688,636,3130380710,066071,G524
5024,PETTORAZZA GRIMANI,RO,1483,761,722,1050710350,029035,G525
5025,PEVERAGNO,CN,5494,2707,2787,1010271630,004163,G526
5026,PEZZANA,VC,1271,630,641,1010880920,002093,G528
5027,PEZZAZE,BS,1448,734,714,1030151320,017141,G529
5028,PEZZOLO VALLE UZZONE,CN,310,153,157,1010271640,004164,G532
5029,PIACENZA,PC,102364,49428,52936,1080610320,033032,G535
5030,PIACENZA D'ADIGE,PD,1231,621,610,1050540620,028062,G534
5031,PIADENA DRIZZONA,CR,3967,1987,1980,1030260695,019116,M418
5032,PIAGGINE,SA,1180,567,613,3150720950,065095,G538
5033,PIAN CAMUNO,BS,4733,2389,2344,1030151330,017142,G546
5034,PIANA CRIXIA,SV,760,377,383,1070740480,009048,G542
5035,PIANA DEGLI ALBANESI,PA,5703,2869,2834,4190550550,082057,G543
5036,PIANA DI MONTE VERNA,CE,2095,1019,1076,3150200560,061056,G541
5037,PIANCASTAGNAIO,SI,3968,1927,2041,2090750200,052020,G547
5038,PIANCOGNO,BS,4742,2410,2332,1030151331,017206,G549
5039,PIANDIMELETO,PU,2061,1015,1046,2110590470,041047,G551
5040,PIANE CRATI,CS,1378,667,711,3180250980,078097,G553
5041,PIANELLA,PE,8524,4223,4301,3130600300,068030,G555
5042,PIANELLO DEL LARIO,CO,1047,515,532,1030241720,013183,G556
5043,PIANELLO VAL TIDONE,PC,2183,1070,1113,1080610330,033033,G557
5044,PIANENGO,CR,2528,1277,1251,1030260701,019072,G558
5045,PIANEZZA,TO,15449,7539,7910,1010811850,001189,G559
5046,PIANEZZE,VI,2163,1061,1102,1050900770,024077,G560
5047,PIANFEI,CN,2100,1073,1027,1010271650,004165,G561
5048,PIANICO,BG,1436,716,720,1030121540,016162,G564
5049,PIANIGA,VE,12237,6046,6191,1050870280,027028,G565
5050,PIANO DI SORRENTO,,12486,6021,6465,3150510530,063053,G568
5051,PIANOPOLI,CZ,2539,1258,1281,3180220930,079096,D546
5052,PIANORO,BO,17586,8594,8992,1080130470,037047,G570
5053,PIANSANO,VT,1886,967,919,2120910420,056043,G571
5054,PIANTEDO,SO,1415,702,713,1030770480,014048,G572
5055,PIARIO,BG,1006,514,492,1030121542,016163,G574
5056,PIASCO,CN,2696,1348,1348,1010271660,004166,G575
5057,PIATEDA,SO,2073,991,1082,1030770490,014049,G576
5058,PIATTO,BI,478,235,243,1010960430,096043,G577
5059,PIAZZA AL SERCHIO,LU,2144,1032,1112,2090430230,046023,G582
5060,PIAZZA ARMERINA,EN,20733,10139,10594,4190280140,086014,G580
5061,PIAZZA BREMBANA,BG,1195,585,610,1030121541,016164,G579
5062,PIAZZATORRE,BG,389,195,194,1030121550,016165,G583
5063,PIAZZOLA SUL BRENTA,PD,11093,5486,5607,1050540630,028063,G587
5064,PIAZZOLO,BG,87,40,47,1030121560,016166,G588
5065,PICCIANO,PE,1287,636,651,3130600310,068031,G589
5066,PICERNO,PZ,5664,2852,2812,3170640580,076059,G590
5067,PICINISCO,FR,1130,551,579,2120330500,060050,G591
5068,PICO,FR,2650,1305,1345,2120330510,060051,G592
5069,PIEA,AT,522,264,258,1010070840,005084,G593
5070,PIEDICAVALLO,BI,174,92,82,1010960440,096044,G594
5071,PIEDIMONTE ETNEO,CT,3926,1949,1977,4190210340,087035,G597
5072,PIEDIMONTE MATESE,CE,10308,4968,5340,3150200570,061057,G596
5073,PIEDIMONTE SAN GERMANO,FR,6310,3150,3160,2120330520,060052,G598
5074,PIEDIMULERA,VB,1465,741,724,1011020530,103053,G600
5075,PIEGARO,PG,3389,1652,1737,2100580400,054040,G601
5076,PIENZA,SI,2007,949,1058,2090750210,052021,G602
5077,PIERANICA,CR,1120,569,551,1030260710,019073,G603
5078,PIETRA DE' GIORGI,PV,755,380,375,1030571080,018111,G612
5079,PIETRA LIGURE,SV,8326,3958,4368,1070740490,009049,G605
5080,PIETRA MARAZZI,AL,867,419,448,1010021260,006129,G619
5081,PIETRABBONDANTE,IS,635,331,304,3140940350,094035,G606
5082,PIETRABRUNA,IM,453,229,224,1070370380,008041,G607
5083,PIETRACAMELA,TE,222,127,95,3130790330,067034,G608
5084,PIETRACATELLA,CB,1249,606,643,3140190530,070053,G609
5085,PIETRACUPA,CB,207,99,108,3140190540,070054,G610
5086,PIETRADEFUSI,AV,1965,958,1007,3150080710,064072,G611
5087,PIETRAFERRAZZANA,CH,130,62,68,3130230651,069103,G613
5088,PIETRAFITTA,CS,1166,574,592,3180250990,078098,G615
5089,PIETRAGALLA,PZ,3863,1916,1947,3170640590,076060,G616
5090,PIETRALUNGA,PG,1990,962,1028,2100580410,054041,G618
5091,PIETRAMELARA,CE,4515,2204,2311,3150200580,061058,G620
5092,PIETRAMONTECORVINO,FG,2511,1220,1291,3160310370,071039,G604
5093,PIETRANICO,PE,435,206,229,3130600320,068032,G621
5094,PIETRAPAOLA,CS,1021,480,541,3180251000,078099,G622
5095,PIETRAPERTOSA,PZ,924,442,482,3170640600,076061,G623
5096,PIETRAPERZIA,EN,6387,3009,3378,4190280150,086015,G624
5097,PIETRAPORZIO,CN,73,38,35,1010271670,004167,G625
5098,PIETRAROJA,BN,512,236,276,3150110500,062051,G626
5099,PIETRARUBBIA,PU,602,314,288,2110590480,041048,G627
5100,PIETRASANTA,LU,23066,10863,12203,2090430240,046024,G628
5101,PIETRASTORNINA,AV,1455,740,715,3150080720,064073,G629
5102,PIETRAVAIRANO,CE,2833,1393,1440,3150200590,061059,G630
5103,PIETRELCINA,BN,2897,1441,1456,3150110510,062052,G631
5104,PIEVE A NIEVOLE,PT,9120,4416,4704,2090630130,047013,G636
5105,PIEVE ALBIGNOLA,PV,836,411,425,1030571090,018112,G635
5106,PIEVE D'OLMI,CR,1233,609,624,1030260720,019074,G647
5107,PIEVE DEL CAIRO,PV,1761,865,896,1030571100,018113,G639
5108,PIEVE DEL GRAPPA,TV,6592,3211,3381,1050840555,026096,M422
5109,PIEVE DI BONO-PREZZO,TN,1428,709,719,1040831295,022234,M365
5110,PIEVE DI CADORE,BL,3681,1770,1911,1050100390,025039,G642
5111,PIEVE DI CENTO,BO,7153,3526,3627,1080130480,037048,G643
5112,PIEVE DI SOLIGO,TV,11680,5753,5927,1050840560,026057,G645
5113,PIEVE DI TECO,IM,1322,650,672,1070370390,008042,G632
5114,PIEVE EMANUELE,MI,15671,7839,7832,1030491720,015173,G634
5115,PIEVE FISSIRAGA,LO,1757,881,876,1030990450,098045,G096
5116,PIEVE FOSCIANA,LU,2263,1139,1124,2090430250,046025,G648
5117,PIEVE LIGURE,GE,2429,1198,1231,1070340430,010043,G646
5118,PIEVE PORTO MORONE,PV,2568,1297,1271,1030571110,018114,G650
5119,PIEVE SAN GIACOMO,CR,1585,781,804,1030260730,019075,G651
5120,PIEVE SANTO STEFANO,AR,2994,1481,1513,2090050300,051030,G653
5121,PIEVE TESINO,TN,652,331,321,1040831310,022142,G656
5122,PIEVE TORINA,MC,1268,627,641,2110440380,043038,G657
5123,PIEVE VERGONTE,VB,2453,1178,1275,1011020540,103054,G658
5124,PIEVEPELAGO,MO,2142,1075,1067,1080500300,036031,G649
5125,PIGLIO,FR,4382,2166,2216,2120330530,060053,G659
5126,PIGNA,IM,763,372,391,1070370400,008043,G660
5127,PIGNATARO INTERAMNA,FR,2447,1204,1243,2120330540,060054,G662
5128,PIGNATARO MAGGIORE,CE,5761,2800,2961,3150200600,061060,G661
5129,PIGNOLA,PZ,6783,3362,3421,3170640610,076062,G663
5130,PIGNONE,SP,519,252,267,1070390210,011021,G664
5131,PIGRA,CO,248,123,125,1030241730,013184,G665
5132,PILA,VC,144,83,61,1010880950,002096,G666
5133,PIMENTEL,SU,1131,590,541,4201110550,111055,G669
5134,PIMONTE,,5868,2934,2934,3150510540,063054,G670
5135,PINAROLO PO,PV,1688,816,872,1030571120,018115,G671
5136,PINASCA,TO,2853,1367,1486,1010811860,001190,G672
5137,PINCARA,RO,1095,547,548,1050710360,029036,G673
5138,PINEROLO,TO,35440,16881,18559,1010811870,001191,G674
5139,PINETO,TE,14538,7015,7523,3130790340,067035,F831
5140,PINO D'ASTI,AT,205,109,96,1010070850,005085,G676
5141,PINO TORINESE,TO,8333,4006,4327,1010811880,001192,G678
5142,PINZANO AL TAGLIAMENTO,PN,1498,728,770,1060930300,093030,G680
5143,PINZOLO,TN,3061,1506,1555,1040831320,022143,G681
5144,PIOBBICO,PU,1798,885,913,2110590490,041049,G682
5145,PIOBESI D'ALBA,CN,1403,700,703,1010271680,004168,G683
5146,PIOBESI TORINESE,TO,3818,1852,1966,1010811890,001193,G684
5147,PIODE,VC,188,91,97,1010880960,002097,G685
5148,PIOLTELLO,MI,36202,18152,18050,1030491740,015175,G686
5149,PIOMBINO,LI,32304,15582,16722,2090420120,049012,G687
5150,PIOMBINO DESE,PD,9480,4785,4695,1050540640,028064,G688
5151,PIORACO,MC,992,488,504,2110440390,043039,G690
5152,PIOSSASCO,TO,18087,8854,9233,1010811900,001194,G691
5153,PIOVA' MASSAIA,AT,581,285,296,1010070860,005086,G692
5154,PIOVE DI SACCO,PD,20138,9773,10365,1050540650,028065,G693
5155,PIOVENE ROCCHETTE,VI,8160,4046,4114,1050900780,024078,G694
5156,PIOZZANO,PC,580,316,264,1080610340,033034,G696
5157,PIOZZO,CN,984,490,494,1010271690,004169,G697
5158,PIRAINO,ME,3798,1857,1941,4190480670,083068,G699
5159,PISA,PI,89002,42767,46235,2090620250,050026,G702
5160,PISANO,NO,779,376,403,1010521130,003119,G703
5161,PISCINA,TO,3319,1622,1697,1010811910,001195,G705
5162,PISCINAS,SU,816,395,421,4201110560,111056,M291
5163,PISCIOTTA,SA,2447,1218,1229,3150720960,065096,G707
5164,PISOGNE,BS,7803,3865,3938,1030151340,017143,G710
5165,PISONIANO,RM,741,368,373,2120700760,058077,G704
5166,PISTICCI,MT,16836,8329,8507,3170470200,077020,G712
5167,PISTOIA,PT,89493,43009,46484,2090630140,047014,G713
5168,PITIGLIANO,GR,3608,1716,1892,2090360180,053019,G716
5169,PIUBEGA,MN,1711,859,852,1030450410,020041,G717
5170,PIURO,SO,1901,944,957,1030770500,014050,G718
5171,PIVERONE,TO,1302,624,678,1010811920,001196,G719
5172,PIZZALE,PV,691,344,347,1030571130,018116,G720
5173,PIZZIGHETTONE,CR,6273,3079,3194,1030260740,019076,G721
5174,PIZZO,VV,8878,4359,4519,3181030270,102027,G722
5175,PIZZOFERRATO,CH,978,506,472,3130230660,069066,G724
5176,PIZZOLI,AQ,4298,2244,2054,3130380720,066072,G726
5177,PIZZONE,IS,315,166,149,3140940360,094036,G727
5178,PIZZONI,VV,1000,488,512,3181030280,102028,G728
5179,PLACANICA,RC,1043,504,539,3180670590,080059,G729
5180,PLATACI,CS,675,342,333,3180251010,078100,G733
5181,PLATANIA,CZ,1948,945,1003,3180220960,079099,G734
5182,PLATI',RC,3736,1891,1845,3180670600,080060,G735
5183,PLAUS/PLAUS,BZ,740,383,357,1040140610,021064,G299
5184,PLESIO,CO,817,426,391,1030241740,013185,G737
5185,PLOAGHE,SS,4350,2182,2168,4200730560,090057,G740
5186,PLODIO,SV,622,316,306,1070740500,009050,G741
5187,POCAPAGLIA,CN,3287,1625,1662,1010271700,004170,G742
5188,POCENIA,UD,2363,1172,1191,1060850750,030075,G743
5189,PODENZANA,MS,2118,1051,1067,2090460130,045013,G746
5190,PODENZANO,PC,9025,4464,4561,1080610350,033035,G747
5191,POFI,FR,3972,1977,1995,2120330550,060055,G749
5192,POGGIARDO,LE,5854,2797,3057,3160410600,075061,G751
5193,POGGIBONSI,SI,28576,13951,14625,2090750220,052022,G752
5194,POGGIO A CAIANO,PO,9956,4889,5067,2091000040,100004,G754
5195,POGGIO BUSTONE,RI,1975,1003,972,2120690490,057051,G756
5196,POGGIO CATINO,RI,1241,605,636,2120690500,057052,G757
5197,POGGIO IMPERIALE,FG,2511,1262,1249,3160310380,071040,G761
5198,POGGIO MIRTETO,RI,6145,3017,3128,2120690510,057053,G763
5199,POGGIO MOIANO,RI,2818,1419,1399,2120690520,057054,G764
5200,POGGIO NATIVO,RI,2569,1357,1212,2120690530,057055,G765
5201,POGGIO PICENZE,AQ,1036,499,537,3130380730,066073,G766
5202,POGGIO RENATICO,FE,9750,4790,4960,1080290160,038018,G768
5203,POGGIO RUSCO,MN,6478,3250,3228,1030450420,020042,G753
5204,POGGIO SAN LORENZO,RI,545,289,256,2120690540,057056,G770
5205,POGGIO SAN MARCELLO,AN,654,329,325,2110030370,042037,G771
5206,POGGIO SAN VICINO,MC,225,106,119,2110440400,043040,D566
5207,POGGIO SANNITA,IS,584,294,290,3140940370,094037,B317
5208,POGGIO TORRIANA,RN,5161,2581,2580,1081010125,099028,M324
5209,POGGIODOMO,PG,99,55,44,2100580420,054042,G758
5210,POGGIOFIORITO,CH,827,403,424,3130230670,069067,G760
5211,POGGIOMARINO,,22011,10999,11012,3150510550,063055,G762
5212,POGGIOREALE,TP,1353,674,679,4190820170,081016,G767
5213,POGGIORSINI,BA,1291,650,641,3160090331,072034,G769
5214,POGGIRIDENTI,SO,1819,879,940,1030770510,014051,G431
5215,POGLIANO MILANESE,MI,8393,4176,4217,1030491750,015176,G772
5216,POGNANA LARIO,CO,667,327,340,1030241750,013186,G773
5217,POGNANO,BG,1560,794,766,1030121570,016167,G774
5218,POGNO,NO,1350,649,701,1010521140,003120,G775
5219,POIRINO,TO,10179,5059,5120,1010811930,001197,G777
5220,POJANA MAGGIORE,VI,4271,2140,2131,1050900790,024079,G776
5221,POLAVENO,BS,2464,1241,1223,1030151350,017144,G779
5222,POLCENIGO,PN,3123,1532,1591,1060930310,093031,G780
5223,POLESELLA,RO,3740,1860,1880,1050710370,029037,G782
5224,POLESINE ZIBELLO,PR,3093,1525,1568,1080560291,034050,M367
5225,POLI,RM,2260,1119,1141,2120700770,058078,G784
5226,POLIA,VV,840,399,441,3181030290,102029,G785
5227,POLICORO,MT,17685,8633,9052,3170470201,077021,G786
5228,POLIGNANO A MARE,BA,17680,8673,9007,3160090340,072035,G787
5229,POLINAGO,MO,1582,801,781,1080500310,036032,G789
5230,POLINO,TR,207,109,98,2100800270,055027,G790
5231,POLISTENA,RC,9960,4843,5117,3180670610,080061,G791
5232,POLIZZI GENEROSA,PA,2975,1430,1545,4190550560,082058,G792
5233,POLLA,SA,5174,2527,2647,3150720970,065097,G793
5234,POLLEIN,AO,1507,744,763,1020040480,007049,G794
5235,POLLENA TROCCHIA,,12976,6283,6693,3150510560,063056,G795
5236,POLLENZA,MC,6307,3130,3177,2110440410,043041,F567
5237,POLLICA,SA,2178,1083,1095,3150720980,065098,G796
5238,POLLINA,PA,2854,1398,1456,4190550570,082059,G797
5239,POLLONE,BI,2033,1004,1029,1010960460,096046,G798
5240,POLLUTRI,CH,2057,1007,1050,3130230680,069068,G799
5241,POLONGHERA,CN,1112,538,574,1010271710,004171,G800
5242,POLPENAZZE DEL GARDA,BS,2705,1355,1350,1030151360,017145,G801
5243,POLVERARA,PD,3373,1659,1714,1050540660,028066,G802
5244,POLVERIGI,AN,4601,2283,2318,2110030380,042038,G803
5245,POMARANCE,PI,5390,2658,2732,2090620260,050027,G804
5246,POMARETTO,TO,971,471,500,1010811931,001198,G805
5247,POMARICO,MT,3832,1903,1929,3170470210,077022,G806
5248,POMARO MONFERRATO,AL,313,152,161,1010021280,006131,G807
5249,POMAROLO,TN,2456,1260,1196,1040831330,022144,G808
5250,POMBIA,NO,2118,1060,1058,1010521150,003121,G809
5251,POMEZIA,RM,64005,31984,32021,2120700780,058079,G811
5252,POMIGLIANO D'ARCO,,39762,19098,20664,3150510570,063057,G812
5253,POMPEI,,24098,11567,12531,3150510580,063058,G813
5254,POMPEIANA,IM,852,415,437,1070370410,008044,G814
5255,POMPIANO,BS,3744,1870,1874,1030151370,017146,G815
5256,POMPONESCO,MN,1671,812,859,1030450430,020043,G816
5257,POMPU,OR,215,116,99,4200950420,095042,G817
5258,PONCARALE,BS,5161,2568,2593,1030151371,017147,G818
5259,PONDERANO,BI,3740,1805,1935,1010960470,096047,G820
5260,PONNA,CO,230,119,111,1030241760,013187,G821
5261,PONSACCO,PI,15577,7611,7966,2090620270,050028,G822
5262,PONSO,PD,2397,1231,1166,1050540670,028067,G823
5263,PONT CANAVESE,TO,3087,1488,1599,1010811940,001199,G826
5264,PONT-SAINT-MARTIN,AO,3553,1688,1865,1020040510,007052,G854
5265,PONTASSIEVE,FI,20304,9904,10400,2090300330,048033,G825
5266,PONTBOSET,AO,171,92,79,1020040490,007050,G545
5267,PONTE,BN,2438,1182,1256,3150110520,062053,G827
5268,PONTE BUGGIANESE,PT,8795,4275,4520,2090630160,047016,G833
5269,PONTE DELL'OLIO,PC,4614,2274,2340,1080610360,033036,G842
5270,PONTE DI LEGNO,BS,1747,846,901,1030151390,017148,G844
5271,PONTE DI PIAVE,TV,8286,4205,4081,1050840570,026058,G846
5272,PONTE GARDENA/WAIDBRUCK,BZ,202,115,87,1040140620,021065,G830
5273,PONTE IN VALTELLINA,SO,2255,1119,1136,1030770520,014052,G829
5274,PONTE LAMBRO,CO,4242,2099,2143,1030241770,013188,G847
5275,PONTE NELLE ALPI,BL,7930,3917,4013,1050100400,025040,B662
5276,PONTE NIZZA,PV,772,379,393,1030571140,018117,G851
5277,PONTE NOSSA,BG,1719,847,872,1030121571,016168,F941
5278,PONTE SAN NICOLO',PD,13307,6418,6889,1050540690,028069,G855
5279,PONTE SAN PIETRO,BG,11481,5713,5768,1030121590,016170,G856
5280,PONTEBBA,UD,1322,652,670,1060850760,030076,G831
5281,PONTECAGNANO FAIANO,SA,25839,12705,13134,3150720990,065099,G834
5282,PONTECCHIO POLESINE,RO,2214,1129,1085,1050710380,029038,G836
5283,PONTECHIANALE,CN,187,95,92,1010271720,004172,G837
5284,PONTECORVO,FR,12438,6106,6332,2120330560,060056,G838
5285,PONTECURONE,AL,3427,1731,1696,1010021290,006132,G839
5286,PONTEDASSIO,IM,2341,1177,1164,1070370420,008045,G840
5287,PONTEDERA,PI,29284,14487,14797,2090620280,050029,G843
5288,PONTELANDOLFO,BN,2021,979,1042,3150110530,062054,G848
5289,PONTELATONE,CE,1543,757,786,3150200610,061061,G849
5290,PONTELONGO,PD,3641,1828,1813,1050540680,028068,G850
5291,PONTENURE,PC,6511,3203,3308,1080610370,033037,G852
5292,PONTERANICA,BG,6682,3325,3357,1030121580,016169,G853
5293,PONTESTURA,AL,1312,641,671,1010021300,006133,G858
5294,PONTEVICO,BS,6991,3283,3708,1030151400,017149,G859
5295,PONTEY,AO,795,403,392,1020040500,007051,G860
5296,PONTI,AL,544,278,266,1010021310,006134,G861
5297,PONTI SUL MINCIO,MN,2275,1113,1162,1030450440,020044,G862
5298,PONTIDA,BG,3276,1663,1613,1030121600,016171,G864
5299,PONTINIA,LT,14913,7447,7466,2120400170,059017,G865
5300,PONTINVREA,SV,820,422,398,1070740510,009051,G866
5301,PONTIROLO NUOVO,BG,4946,2499,2447,1030121610,016172,G867
5302,PONTOGLIO,BS,6902,3459,3443,1030151410,017150,G869
5303,PONTREMOLI,MS,6931,3302,3629,2090460140,045014,G870
5304,PONZA,LT,3305,1729,1576,2120400180,059018,G871
5305,PONZANO DI FERMO,FM,1641,835,806,2111050320,109032,G873
5306,PONZANO MONFERRATO,AL,315,156,159,1010021320,006135,G872
5307,PONZANO ROMANO,RM,1161,609,552,2120700790,058080,G874
5308,PONZANO VENETO,TV,12981,6412,6569,1050840580,026059,G875
5309,PONZONE,AL,999,526,473,1010021330,006136,G877
5310,POPOLI TERME,PE,4757,2296,2461,3130600330,068033,G878
5311,POPPI,AR,5879,2963,2916,2090050310,051031,G879
5312,PORANO,TR,1904,909,995,2100800280,055028,G881
5313,PORCARI,LU,8789,4340,4449,2090430260,046026,G882
5314,PORCIA,PN,14985,7270,7715,1060930320,093032,G886
5315,PORDENONE,PN,51617,24818,26799,1060930330,093033,G888
5316,PORLEZZA,CO,4820,2371,2449,1030241780,013189,G889
5317,PORNASSIO,IM,656,385,271,1070370430,008046,G890
5318,PORPETTO,UD,2475,1230,1245,1060850770,030077,G891
5319,PORTACOMARO,AT,1926,947,979,1010070870,005087,G894
5320,PORTALBERA,PV,1449,708,741,1030571150,018118,G895
5321,PORTE,TO,1079,547,532,1010811950,001200,G900
5322,PORTE DI RENDENA,TN,1782,893,889,1040831335,022244,M358
5323,PORTICI,,52500,24687,27813,3150510590,063059,G902
5324,PORTICO DI CASERTA,CE,7768,3826,3942,3150200620,061062,G903
5325,PORTICO E SAN BENEDETTO,FC,735,368,367,1080320300,040031,G904
5326,PORTIGLIOLA,RC,1091,530,561,3180670620,080062,G905
5327,PORTO AZZURRO,LI,3640,1870,1770,2090420130,049013,E680
5328,PORTO CERESIO,VA,2838,1385,1453,1030860970,012113,G906
5329,PORTO CESAREO,LE,6300,3163,3137,3160410601,075097,M263
5330,PORTO EMPEDOCLE,AG,15661,7679,7982,4190010280,084028,F299
5331,PORTO MANTOVANO,MN,16498,8119,8379,1030450450,020045,G917
5332,PORTO RECANATI,MC,12324,6315,6009,2110440420,043042,G919
5333,PORTO SAN GIORGIO,FM,15699,7419,8280,2111050330,109033,G920
5334,PORTO SANT'ELPIDIO,FM,25757,12601,13156,2111050340,109034,G921
5335,PORTO TOLLE,RO,9135,4501,4634,1050710390,029039,G923
5336,PORTO TORRES,SS,21330,10454,10876,4200730570,090058,G924
5337,PORTO VALTRAVAGLIA,VA,2266,1078,1188,1030860980,012114,G907
5338,PORTO VIRO,RO,13782,6735,7047,1050710391,029052,G926
5339,PORTOBUFFOLE',TV,736,361,375,1050840590,026060,G909
5340,PORTOCANNONE,CB,2339,1187,1152,3140190550,070055,G910
5341,PORTOFERRAIO,LI,11864,5768,6096,2090420140,049014,G912
5342,PORTOFINO,GE,369,187,182,1070340440,010044,G913
5343,PORTOGRUARO,VE,24488,11789,12699,1050870290,027029,G914
5344,PORTOMAGGIORE,FE,11584,5784,5800,1080290170,038019,G916
5345,PORTOPALO DI CAPO PASSERO,SR,3798,1933,1865,4190760151,089020,M257
5346,PORTOSCUSO,SU,4869,2405,2464,4201110570,111057,G922
5347,PORTOVENERE,SP,3310,1661,1649,1070390220,011022,G925
5348,PORTULA,BI,1133,563,570,1010960480,096048,G927
5349,POSADA,NU,3020,1541,1479,4200530710,091073,G929
5350,POSINA,VI,558,288,270,1050900800,024080,G931
5351,POSITANO,SA,3772,1849,1923,3150721000,065100,G932
5352,POSSAGNO,TV,2224,1132,1092,1050840600,026061,G933
5353,POSTA,RI,566,307,259,2120690550,057057,G934
5354,POSTA FIBRENO,FR,1060,516,544,2120330561,060057,G935
5355,POSTAL/BURGSTALL,BZ,1964,963,1001,1040140630,021066,G936
5356,POSTALESIO,SO,659,332,327,1030770530,014053,G937
5357,POSTIGLIONE,SA,1998,1002,996,3150721010,065101,G939
5358,POSTUA,VC,561,285,276,1010881010,002102,G940
5359,POTENZA,PZ,64850,31168,33682,3170640620,076063,G942
5360,POTENZA PICENA,MC,15515,7575,7940,2110440430,043043,F632
5361,POVE DEL GRAPPA,VI,3160,1541,1619,1050900810,024081,G943
5362,POVEGLIANO,TV,5104,2559,2545,1050840610,026062,G944
5363,POVEGLIANO VERONESE,VR,7330,3608,3722,1050890590,023060,G945
5364,POVIGLIO,RE,7096,3557,3539,1080680290,035029,G947
5365,POVOLETTO,UD,5410,2678,2732,1060850780,030078,G949
5366,POZZAGLIA SABINA,RI,308,154,154,2120690560,057058,G951
5367,POZZAGLIO ED UNITI,CR,1443,730,713,1030260750,019077,B914
5368,POZZALLO,RG,18997,9409,9588,4190650080,088008,G953
5369,POZZILLI,IS,2174,1080,1094,3140940380,094038,G954
5370,POZZO D'ADDA,MI,6472,3286,3186,1030491760,015177,G955
5371,POZZOL GROPPO,AL,296,152,144,1010021340,006137,G960
5372,POZZOLENGO,BS,3556,1789,1767,1030151420,017151,G959
5373,POZZOLEONE,VI,2773,1451,1322,1050900820,024082,G957
5374,POZZOLO FORMIGARO,AL,4513,2270,2243,1010021350,006138,G961
5375,POZZOMAGGIORE,SS,2416,1191,1225,4200730580,090059,G962
5376,POZZONOVO,PD,3482,1713,1769,1050540700,028070,G963
5377,POZZUOLI,,76952,37464,39488,3150510600,063060,G964
5378,POZZUOLO DEL FRIULI,UD,6906,3360,3546,1060850790,030079,G966
5379,POZZUOLO MARTESANA,MI,8543,4174,4369,1030491770,015178,G965
5380,PRADALUNGA,BG,4518,2248,2270,1030121620,016173,G968
5381,PRADAMANO,UD,3522,1697,1825,1060850800,030080,G969
5382,PRADLEVES,CN,241,126,115,1010271730,004173,G970
5383,PRAGELATO,TO,735,402,333,1010811960,001201,G973
5384,PRAIA A MARE,CS,6418,3020,3398,3180251020,078101,G975
5385,PRAIANO,SA,2009,998,1011,3150721020,065102,G976
5386,PRALBOINO,BS,2803,1448,1355,1030151430,017152,G977
5387,PRALI,TO,249,131,118,1010811970,001202,G978
5388,PRALORMO,TO,1899,941,958,1010811980,001203,G979
5389,PRALUNGO,BI,2290,1113,1177,1010960490,096049,G980
5390,PRAMAGGIORE,VE,4721,2364,2357,1050870300,027030,G981
5391,PRAMOLLO,TO,222,119,103,1010811981,001204,G982
5392,PRAROLO,VC,708,352,356,1010881030,002104,G985
5393,PRAROSTINO,TO,1255,639,616,1010811982,001205,G986
5394,PRASCO,AL,479,242,237,1010021360,006139,G987
5395,PRASCORSANO,TO,726,371,355,1010811990,001206,G988
5396,PRATA CAMPORTACCIO,SO,2918,1464,1454,1030770540,014054,G993
5397,PRATA D'ANSIDONIA,AQ,453,228,225,3130380740,066074,G992
5398,PRATA DI PORDENONE,PN,8350,4204,4146,1060930340,093034,G994
5399,PRATA DI PRINCIPATO ULTRA,AV,2781,1416,1365,3150080730,064074,G990
5400,PRATA SANNITA,CE,1394,669,725,3150200630,061063,G991
5401,PRATELLA,CE,1457,727,730,3150200640,061064,G995
5402,PRATIGLIONE,TO,458,225,233,1010812000,001207,G997
5403,PRATO,PO,195213,95463,99750,2091000050,100005,G999
5404,PRATO ALLO STELVIO/PRAD AM STILFSER JOCH,BZ,3734,1876,1858,1040140640,021067,H004
5405,PRATO CARNICO,UD,853,433,420,1060850810,030081,H002
5406,PRATO SESIA,NO,1849,921,928,1010521160,003122,H001
5407,PRATOLA PELIGNA,AQ,7132,3499,3633,3130380750,066075,H007
5408,PRATOLA SERRA,AV,3643,1785,1858,3150080740,064075,H006
5409,PRATOVECCHIO STIA,AR,5439,2669,2770,2090050321,051041,M329
5410,PRAVISDOMINI,PN,3410,1691,1719,1060930350,093035,H010
5411,PRAY,BI,2008,949,1059,1010960500,096050,G974
5412,PRAZZO,CN,177,90,87,1010271740,004174,H011
5413,PRE'-SAINT-DIDIER,AO,977,515,462,1020040520,007053,H042
5414,PRECENICCO,UD,1433,725,708,1060850820,030082,H014
5415,PRECI,PG,683,340,343,2100580430,054043,H015
5416,PREDAIA,TN,6815,3398,3417,1040831355,022230,M344
5417,PREDAPPIO,FC,6237,3141,3096,1080320310,040032,H017
5418,PREDAZZO,TN,4502,2208,2294,1040831360,022147,H018
5419,PREDOI/PRETTAU,BZ,528,265,263,1040140641,021068,H019
5420,PREDORE,BG,1846,906,940,1030121630,016174,H020
5421,PREDOSA,AL,1895,929,966,1010021370,006140,H021
5422,PREGANZIOL,TV,16799,8268,8531,1050840620,026063,H022
5423,PREGNANA MILANESE,MI,7286,3623,3663,1030491780,015179,H026
5424,PRELA',IM,482,249,233,1070370440,008047,H027
5425,PREMANA,LC,2178,1108,1070,1030980690,097069,H028
5426,PREMARIACCO,UD,3973,1943,2030,1060850830,030083,H029
5427,PREMENO,VB,764,378,386,1011020550,103055,H030
5428,PREMIA,VB,544,271,273,1011020560,103056,H033
5429,PREMILCUORE,FC,708,353,355,1080320320,040033,H034
5430,PREMOLO,BG,1061,562,499,1030121640,016175,H036
5431,PREMOSELLO-CHIOVENDA,VB,1838,885,953,1011020570,103057,H037
5432,PREONE,UD,252,129,123,1060850840,030084,H038
5433,PREPOTTO,UD,713,359,354,1060850850,030085,H040
5434,PRESEGLIE,BS,1465,767,698,1030151440,017153,H043
5435,PRESENZANO,CE,1658,843,815,3150200650,061065,H045
5436,PRESEZZO,BG,4802,2352,2450,1030121650,016176,H046
5437,PRESICCE-ACQUARICA,LE,9402,4514,4888,3160410611,075098,M428
5438,PRESSANA,VR,2510,1306,1204,1050890600,023061,H048
5439,PRETORO,CH,865,419,446,3130230690,069069,H052
5440,PREVALLE,BS,6815,3425,3390,1030151460,017155,H055
5441,PREZZA,AQ,886,438,448,3130380760,066076,H056
5442,PRIERO,CN,525,264,261,1010271750,004175,H059
5443,PRIGNANO CILENTO,SA,1070,538,532,3150721030,065103,H062
5444,PRIGNANO SULLA SECCHIA,MO,3763,1918,1845,1080500320,036033,H061
5445,PRIMALUNA,LC,2246,1103,1143,1030980700,097070,H063
5446,PRIMIERO SAN MARTINO DI CASTROZZA,TN,5182,2557,2625,1040831375,022245,M359
5447,PRIOCCA,CN,2025,998,1027,1010271760,004176,H068
5448,PRIOLA,CN,658,328,330,1010271770,004177,H069
5449,PRIOLO GARGALLO,SR,11453,5663,5790,4190760152,089021,M279
5450,PRIVERNO,LT,13792,6800,6992,2120400190,059019,G698
5451,PRIZZI,PA,4264,2044,2220,4190550580,082060,H070
5452,PROCENO,VT,528,281,247,2120910430,056044,H071
5453,PROCIDA,,10160,5039,5121,3150510610,063061,H072
5454,PROPATA,GE,113,66,47,1070340450,010045,H073
5455,PROSERPIO,CO,940,463,477,1030241810,013192,H074
5456,PROSSEDI,LT,1171,596,575,2120400200,059020,H076
5457,PROVAGLIO D'ISEO,BS,7161,3536,3625,1030151470,017156,H078
5458,PROVAGLIO VAL SABBIA,BS,884,456,428,1030151480,017157,H077
5459,PROVES/PROVEIS,BZ,258,149,109,1040140650,021069,H081
5460,PROVVIDENTI,CB,107,58,49,3140190560,070056,H083
5461,PRUNETTO,CN,409,206,203,1010271780,004178,H085
5462,PUEGNAGO DEL GARDA,BS,3464,1707,1757,1030151490,017158,H086
5463,PUGLIANELLO,BN,1304,646,658,3150110540,062055,H087
5464,PULA,CA,7106,3581,3525,4200170500,092050,H088
5465,PULFERO,UD,855,442,413,1060850860,030086,H089
5466,PULSANO,TA,11204,5539,5665,3160780220,073022,H090
5467,PUMENENGO,BG,1679,846,833,1030121660,016177,H091
5468,PUSIANO,CO,1334,648,686,1030241820,013193,H094
5469,PUTIFIGARI,SS,691,348,343,4200730590,090060,H095
5470,PUTIGNANO,BA,26087,12775,13312,3160090350,072036,H096
5471,QUADRELLE,AV,1802,899,903,3150080750,064076,H097
5472,QUADRI,CH,717,337,380,3130230700,069070,H098
5473,QUAGLIUZZO,TO,333,173,160,1010812010,001208,H100
5474,QUALIANO,,24723,12277,12446,3150510620,063062,H101
5475,QUARANTI,AT,150,80,70,1010070880,005088,H102
5476,QUAREGNA CERRETO,BI,2031,1010,1021,1010960515,096087,M414
5477,QUARGNENTO,AL,1347,654,693,1010021380,006141,H104
5478,QUARNA SOPRA,VB,252,116,136,1011020580,103058,H106
5479,QUARNA SOTTO,VB,365,184,181,1011020590,103059,H107
5480,QUARONA,VC,3804,1770,2034,1010881060,002107,H108
5481,QUARRATA,PT,26795,13110,13685,2090630161,047017,H109
5482,QUART,AO,4089,2051,2038,1020040530,007054,H110
5483,QUARTO,,41290,20273,21017,3150510630,063063,H114
5484,QUARTO D'ALTINO,VE,8000,3905,4095,1050870310,027031,H117
5485,QUARTU SANT'ELENA,CA,68853,33694,35159,4200170510,092051,H118
5486,QUARTUCCIU,CA,12910,6351,6559,4200170501,092105,H119
5487,QUASSOLO,TO,339,163,176,1010812011,001209,H120
5488,QUATTORDIO,AL,1497,732,765,1010021390,006142,H121
5489,QUATTRO CASTELLA,RE,13123,6405,6718,1080680300,035030,H122
5490,QUILIANO,SV,6902,3347,3555,1070740520,009052,H126
5491,QUINCINETTO,TO,992,489,503,1010812020,001210,H127
5492,QUINDICI,AV,1825,924,901,3150080760,064077,H128
5493,QUINGENTOLE,MN,1058,509,549,1030450460,020046,H129
5494,QUINTANO,CR,894,449,445,1030260760,019078,H130
5495,QUINTO DI TREVISO,TV,9945,4905,5040,1050840630,026064,H131
5496,QUINTO VERCELLESE,VC,391,192,199,1010881070,002108,H132
5497,QUINTO VICENTINO,VI,5868,2894,2974,1050900830,024083,H134
5498,QUINZANO D'OGLIO,BS,6177,3097,3080,1030151500,017159,H140
5499,QUISTELLO,MN,5320,2605,2715,1030450470,020047,H143
5500,RABBI,TN,1345,692,653,1040831390,022150,H146
5501,RACALE,LE,10743,5184,5559,3160410620,075063,H147
5502,RACALMUTO,AG,7645,3725,3920,4190010290,084029,H148
5503,RACCONIGI,CN,9622,4749,4873,1010271790,004179,H150
5504,RACCUJA,ME,889,436,453,4190480680,083069,H151
5505,RACINES/RATSCHINGS,BZ,4580,2348,2232,1040140660,021070,H152
5506,RADDA IN CHIANTI,SI,1470,718,752,2090750230,052023,H153
5507,RADDUSA,CT,2848,1389,1459,4190210350,087036,H154
5508,RADICOFANI,SI,1065,510,555,2090750240,052024,H156
5509,RADICONDOLI,SI,925,480,445,2090750250,052025,H157
5510,RAFFADALI,AG,12184,5866,6318,4190010300,084030,H159
5511,RAGALNA,CT,4184,2133,2051,4190210351,087058,M287
5512,RAGOGNA,UD,2812,1380,1432,1060850870,030087,H161
5513,RAGUSA,RG,72779,35437,37342,4190650090,088009,H163
5514,RAIANO,AQ,2631,1263,1368,3130380770,066077,H166
5515,RAMACCA,CT,10344,5203,5141,4190210360,087037,H168
5516,RANCIO VALCUVIA,VA,906,454,452,1030860990,012115,H173
5517,RANCO,VA,1251,624,627,1030860992,012116,H174
5518,RANDAZZO,CT,10313,4938,5375,4190210370,087038,H175
5519,RANICA,BG,5879,2870,3009,1030121670,016178,H176
5520,RANZANICO,BG,1239,627,612,1030121680,016179,H177
5521,RANZO,IM,558,273,285,1070370450,008048,H180
5522,RAPAGNANO,FM,1927,946,981,2111050350,109035,H182
5523,RAPALLO,GE,29107,13838,15269,1070340460,010046,H183
5524,RAPINO,CH,1202,600,602,3130230710,069071,H184
5525,RAPOLANO TERME,SI,5030,2463,2567,2090750260,052026,H185
5526,RAPOLLA,PZ,4191,2120,2071,3170640630,076064,H186
5527,RAPONE,PZ,885,419,466,3170640640,076065,H187
5528,RASSA,VC,62,35,27,1010881090,002110,H188
5529,RASUN ANTERSELVA/RASEN-ANTHOLZ,BZ,2911,1455,1456,1040140661,021071,H189
5530,RASURA,SO,291,151,140,1030770550,014055,H192
5531,RAVANUSA,AG,10500,5093,5407,4190010310,084031,H194
5532,RAVARINO,MO,6214,3067,3147,1080500330,036034,H195
5533,RAVASCLETTO,UD,494,251,243,1060850880,030088,H196
5534,RAVELLO,SA,2395,1173,1222,3150721040,065104,H198
5535,RAVENNA,RA,155836,75796,80040,1080660140,039014,H199
5536,RAVEO,UD,444,216,228,1060850890,030089,H200
5537,RAVISCANINA,CE,1184,573,611,3150200660,061066,H202
5538,RE,VB,698,346,352,1011020600,103060,H203
5539,REA,PV,389,177,212,1030571161,018119,H204
5540,REALMONTE,AG,4384,2161,2223,4190010320,084032,H205
5541,REANA DEL ROJALE,UD,4737,2313,2424,1060850900,030090,H206
5542,REANO,TO,1753,866,887,1010812030,001211,H207
5543,RECALE,CE,7647,3814,3833,3150200670,061067,H210
5544,RECANATI,MC,20697,10010,10687,2110440440,043044,H211
5545,RECCO,GE,9464,4448,5016,1070340470,010047,H212
5546,RECETTO,NO,956,504,452,1010521230,003129,H213
5547,RECOARO TERME,VI,6076,3018,3058,1050900840,024084,H214
5548,REDAVALLE,PV,1064,547,517,1030571170,018120,H216
5549,REDONDESCO,MN,1214,607,607,1030450480,020048,H218
5550,REFRANCORE,AT,1579,779,800,1010070890,005089,H219
5551,REFRONTOLO,TV,1728,854,874,1050840640,026065,H220
5552,REGALBUTO,EN,6743,3336,3407,4190280160,086016,H221
5553,REGGELLO,FI,16529,8168,8361,2090300350,048035,H222
5554,REGGIO DI CALABRIA,RC,172479,82576,89903,3180670630,080063,H224
5555,REGGIO NELL'EMILIA,RE,169908,83739,86169,1080680330,035033,H223
5556,REGGIOLO,RE,9123,4592,4531,1080680320,035032,H225
5557,REINO,BN,1112,547,565,3150110550,062056,H227
5558,REITANO,ME,733,373,360,4190480690,083070,H228
5559,REMANZACCO,UD,6064,2935,3129,1060850910,030091,H229
5560,REMEDELLO,BS,3346,1682,1664,1030151510,017160,H230
5561,RENATE,MB,3991,1998,1993,1031040370,108037,H233
5562,RENDE,CS,36123,17780,18343,3180251030,078102,H235
5563,RENON/RITTEN,BZ,8062,4043,4019,1040140680,021072,H236
5564,RESANA,TV,9380,4714,4666,1050840650,026066,H238
5565,RESCALDINA,MI,14129,6966,7163,1030491800,015181,H240
5566,RESIA,UD,933,478,455,1060850920,030092,H242
5567,RESIUTTA,UD,259,130,129,1060850930,030093,H244
5568,RESUTTANO,CL,1767,863,904,4190180140,085014,H245
5569,RETORBIDO,PV,1530,718,812,1030571180,018121,H246
5570,REVELLO,CN,4193,2132,2061,1010271800,004180,H247
5571,REVIGLIASCO D'ASTI,AT,729,362,367,1010070900,005090,H250
5572,REVINE LAGO,TV,2103,1060,1043,1050840660,026067,H253
5573,REZZAGO,CO,308,163,145,1030241840,013195,H255
5574,REZZATO,BS,13345,6610,6735,1030151520,017161,H256
5575,REZZO,IM,312,156,156,1070370460,008049,H257
5576,REZZOAGLIO,GE,875,428,447,1070340480,010048,H258
5577,RHEMES-NOTRE-DAME,AO,81,44,37,1020040540,007055,H262
5578,RHEMES-SAINT-GEORGES,AO,167,87,80,1020040550,007056,H263
5579,RHO,MI,50618,24454,26164,1030491810,015182,H264
5580,RIACE,RC,1813,900,913,3180670640,080064,H265
5581,RIALTO,SV,546,278,268,1070740530,009053,H266
5582,RIANO,RM,10271,5145,5126,2120700800,058081,H267
5583,RIARDO,CE,2245,1104,1141,3150200680,061068,H268
5584,RIBERA,AG,17986,8676,9310,4190010330,084033,H269
5585,RIBORDONE,TO,49,27,22,1010812040,001212,H270
5586,RICADI,VV,4959,2506,2453,3181030300,102030,H271
5587,RICALDONE,AL,612,320,292,1010021400,006143,H272
5588,RICCIA,CB,4901,2416,2485,3140190570,070057,H273
5589,RICCIONE,RN,34603,16320,18283,1081010130,099013,H274
5590,RICCO' DEL GOLFO DI SPEZIA,SP,3615,1789,1826,1070390230,011023,H275
5591,RICENGO,CR,1738,882,856,1030260770,019079,H276
5592,RICIGLIANO,SA,1073,521,552,3150721050,065105,H277
5593,RIESE PIO X,TV,10901,5485,5416,1050840670,026068,H280
5594,RIESI,CL,10631,5055,5576,4190180150,085015,H281
5595,RIETI,RI,45557,22012,23545,2120690570,057059,H282
5596,RIFIANO/RIFFIAN,BZ,1370,696,674,1040140690,021073,H284
5597,RIFREDDO,CN,1050,524,526,1010271810,004181,H285
5598,RIGNANO FLAMINIO,RM,10105,4948,5157,2120700810,058082,H288
5599,RIGNANO GARGANICO,FG,1847,894,953,3160310390,071041,H287
5600,RIGNANO SULL'ARNO,FI,8566,4267,4299,2090300360,048036,H286
5601,RIGOLATO,UD,369,194,175,1060850940,030094,H289
5602,RIMELLA,VC,133,79,54,1010881120,002113,H293
5603,RIMINI,RN,149169,71866,77303,1081010140,099014,H294
5604,RIO,LI,3315,1660,1655,2090420155,049021,M391
5605,RIO DI PUSTERIA/MUHLBACH,BZ,3142,1584,1558,1040140700,021074,H299
5606,RIO SALICETO,RE,6002,3004,2998,1080680340,035034,H298
5607,RIOFREDDO,RM,739,365,374,2120700820,058083,H300
5608,RIOLA SARDO,OR,2060,1067,993,4200950430,095043,H301
5609,RIOLO TERME,RA,5767,2889,2878,1080660150,039015,H302
5610,RIOLUNATO,MO,662,343,319,1080500340,036035,H303
5611,RIOMAGGIORE,SP,1353,676,677,1070390240,011024,H304
5612,RIONERO IN VULTURE,PZ,12636,6273,6363,3170640650,076066,H307
5613,RIONERO SANNITICO,IS,998,516,482,3140940390,094039,H308
5614,RIPA TEATINA,CH,3981,2016,1965,3130230720,069072,H320
5615,RIPABOTTONI,CB,456,226,230,3140190580,070058,H311
5616,RIPACANDIDA,PZ,1594,812,782,3170640660,076067,H312
5617,RIPALIMOSANI,CB,3036,1554,1482,3140190590,070059,H313
5618,RIPALTA ARPINA,CR,1001,518,483,1030260780,019080,H314
5619,RIPALTA CREMASCA,CR,3414,1716,1698,1030260790,019081,H315
5620,RIPALTA GUERINA,CR,532,285,247,1030260791,019082,H316
5621,RIPARBELLA,PI,1572,789,783,2090620290,050030,H319
5622,RIPATRANSONE,AP,4042,2008,2034,2110060620,044063,H321
5623,RIPE SAN GINESIO,MC,818,399,419,2110440450,043045,H323
5624,RIPI,FR,5059,2509,2550,2120330570,060058,H324
5625,RIPOSTO,CT,14078,6884,7194,4190210380,087039,H325
5626,RITTANA,CN,109,52,57,1010271820,004182,H326
5627,RIVA DEL GARDA,TN,17742,8519,9223,1040831420,022153,H330
5628,RIVA DEL PO,FE,7511,3687,3824,1080290175,038029,M410
5629,RIVA DI SOLTO,BG,881,436,445,1030121690,016180,H331
5630,RIVA LIGURE,IM,2812,1411,1401,1070370461,008050,H328
5631,RIVA PRESSO CHIERI,TO,4750,2349,2401,1010812070,001215,H337
5632,RIVALBA,TO,1158,575,583,1010812050,001213,H333
5633,RIVALTA BORMIDA,AL,1394,688,706,1010021410,006144,H334
5634,RIVALTA DI TORINO,TO,20172,9951,10221,1010812060,001214,H335
5635,RIVAMONTE AGORDINO,BL,627,331,296,1050100430,025043,H327
5636,RIVANAZZANO TERME,PV,5139,2454,2685,1030571190,018122,H336
5637,RIVARA,TO,2496,1236,1260,1010812080,001216,H338
5638,RIVAROLO CANAVESE,TO,12280,5916,6364,1010812090,001217,H340
5639,RIVAROLO DEL RE ED UNITI,CR,1824,925,899,1030260800,019083,H341
5640,RIVAROLO MANTOVANO,MN,2415,1189,1226,1030450500,020050,H342
5641,RIVARONE,AL,393,229,164,1010021420,006145,H343
5642,RIVAROSSA,TO,1548,775,773,1010812100,001218,H344
5643,RIVE,VC,424,207,217,1010881140,002115,H346
5644,RIVE D'ARCANO,UD,2358,1138,1220,1060850950,030095,H347
5645,RIVELLO,PZ,2542,1216,1326,3170640670,076068,H348
5646,RIVERGARO,PC,7023,3454,3569,1080610380,033038,H350
5647,RIVIGNANO TEOR,UD,6185,3107,3078,1060850965,030188,M317
5648,RIVISONDOLI,AQ,674,367,307,3130380780,066078,H353
5649,RIVODUTRI,RI,1150,591,559,2120690580,057060,H354
5650,RIVOLI,TO,47481,22771,24710,1010812110,001219,H355
5651,RIVOLI VERONESE,VR,2175,1099,1076,1050890610,023062,H356
5652,RIVOLTA D'ADDA,CR,8137,4018,4119,1030260810,019084,H357
5653,RIZZICONI,RC,7711,3939,3772,3180670650,080065,H359
5654,ROANA,VI,4161,2117,2044,1050900850,024085,H361
5655,ROASCHIA,CN,95,49,46,1010271830,004183,H362
5656,ROASCIO,CN,91,45,46,1010271840,004184,H363
5657,ROASIO,VC,2250,1090,1160,1010881150,002116,H365
5658,ROATTO,AT,368,185,183,1010070910,005091,H366
5659,ROBASSOMERO,TO,3052,1489,1563,1010812120,001220,H367
5660,ROBBIATE,LC,6262,3104,3158,1030980710,097071,G223
5661,ROBBIO,PV,5767,2775,2992,1030571200,018123,H369
5662,ROBECCHETTO CON INDUNO,MI,4767,2377,2390,1030491820,015183,H371
5663,ROBECCO D'OGLIO,CR,2249,1078,1171,1030260820,019085,H372
5664,ROBECCO PAVESE,PV,518,259,259,1030571210,018124,H375
5665,ROBECCO SUL NAVIGLIO,MI,6745,3309,3436,1030491830,015184,H373
5666,ROBELLA,AT,437,234,203,1010070920,005092,H376
5667,ROBILANTE,CN,2147,1061,1086,1010271850,004185,H377
5668,ROBURENT,CN,476,239,237,1010271860,004186,H378
5669,ROCCA CANAVESE,TO,1667,831,836,1010812130,001221,H386
5670,ROCCA CANTERANO,RM,182,97,85,2120700830,058084,H387
5671,ROCCA CIGLIE',CN,125,58,67,1010271880,004188,H391
5672,ROCCA D'ARAZZO,AT,909,464,445,1010070930,005093,H392
5673,ROCCA D'ARCE,FR,911,453,458,2120330580,060059,H393
5674,ROCCA D'EVANDRO,CE,3042,1504,1538,3150200690,061069,H398
5675,ROCCA DE' BALDI,CN,1565,778,787,1010271890,004189,H395
5676,ROCCA DE' GIORGI,PV,60,31,29,1030571220,018125,H396
5677,ROCCA DI BOTTE,AQ,856,459,397,3130380800,066080,H399
5678,ROCCA DI CAMBIO,AQ,490,257,233,3130380810,066081,H400
5679,ROCCA DI CAVE,RM,349,178,171,2120700840,058085,H401
5680,ROCCA DI MEZZO,AQ,1348,688,660,3130380820,066082,H402
5681,ROCCA DI NETO,KR,5343,2675,2668,3180970190,101019,H403
5682,ROCCA DI PAPA,RM,17390,8897,8493,2120700850,058086,H404
5683,ROCCA GRIMALDA,AL,1430,742,688,1010021440,006147,H414
5684,ROCCA IMPERIALE,CS,3226,1603,1623,3180251040,078103,H416
5685,ROCCA MASSIMA,LT,1080,562,518,2120400220,059022,H421
5686,ROCCA PIA,AQ,178,96,82,3130380830,066083,H429
5687,ROCCA PIETORE,BL,1146,559,587,1050100440,025044,H379
5688,ROCCA PRIORA,RM,12076,6042,6034,2120700870,058088,H432
5689,ROCCA SAN CASCIANO,FC,1791,888,903,1080320350,040036,H437
5690,ROCCA SAN FELICE,AV,797,402,395,3150080780,064079,H438
5691,ROCCA SAN GIOVANNI,CH,2281,1145,1136,3130230740,069074,H439
5692,ROCCA SANTA MARIA,TE,477,258,219,3130790350,067036,H440
5693,ROCCA SANTO STEFANO,RM,934,482,452,2120700880,058089,H441
5694,ROCCA SINIBALDA,RI,790,420,370,2120690600,057062,H446
5695,ROCCA SUSELLA,PV,228,114,114,1030571230,018126,H450
5696,ROCCABASCERANA,AV,2319,1167,1152,3150080770,064078,H382
5697,ROCCABERNARDA,KR,3167,1557,1610,3180970180,101018,H383
5698,ROCCABIANCA,PR,2887,1432,1455,1080560300,034030,H384
5699,ROCCABRUNA,CN,1531,750,781,1010271870,004187,H385
5700,ROCCACASALE,AQ,598,301,297,3130380790,066079,H389
5701,ROCCADASPIDE,SA,6971,3413,3558,3150721060,065106,H394
5702,ROCCAFIORITA,ME,182,82,100,4190480700,083071,H405
5703,ROCCAFLUVIONE,AP,1903,967,936,2110060630,044064,H390
5704,ROCCAFORTE DEL GRECO,RC,367,184,183,3180670660,080066,H408
5705,ROCCAFORTE LIGURE,AL,123,74,49,1010021430,006146,H406
5706,ROCCAFORTE MONDOVI',CN,2056,1063,993,1010271900,004190,H407
5707,ROCCAFORZATA,TA,1800,886,914,3160780230,073023,H409
5708,ROCCAFRANCA,BS,4835,2444,2391,1030151530,017162,H410
5709,ROCCAGIOVINE,RM,259,128,131,2120700860,058087,H411
5710,ROCCAGLORIOSA,SA,1563,778,785,3150721070,065107,H412
5711,ROCCAGORGA,LT,4202,2087,2115,2120400210,059021,H413
5712,ROCCALBEGNA,GR,923,470,453,2090360190,053020,H417
5713,ROCCALUMERA,ME,3914,1914,2000,4190480710,083072,H418
5714,ROCCAMANDOLFI,IS,857,431,426,3140940400,094040,H420
5715,ROCCAMENA,PA,1394,672,722,4190550590,082061,H422
5716,ROCCAMONFINA,CE,3206,1562,1644,3150200700,061070,H423
5717,ROCCAMONTEPIANO,CH,1572,775,797,3130230730,069073,H424
5718,ROCCAMORICE,PE,894,418,476,3130600340,068034,H425
5719,ROCCANOVA,PZ,1313,640,673,3170640680,076069,H426
5720,ROCCANTICA,RI,548,268,280,2120690590,057061,H427
5721,ROCCAPALUMBA,PA,2264,1094,1170,4190550600,082062,H428
5722,ROCCAPIEMONTE,SA,8718,4292,4426,3150721080,065108,H431
5723,ROCCARAINOLA,,6623,3218,3405,3150510650,063065,H433
5724,ROCCARASO,AQ,1507,752,755,3130380840,066084,H434
5725,ROCCAROMANA,CE,839,389,450,3150200710,061071,H436
5726,ROCCASCALEGNA,CH,1057,538,519,3130230750,069075,H442
5727,ROCCASECCA,FR,6975,3498,3477,2120330590,060060,H443
5728,ROCCASECCA DEI VOLSCI,LT,1050,524,526,2120400230,059023,H444
5729,ROCCASICURA,IS,492,247,245,3140940410,094041,H445
5730,ROCCASPARVERA,CN,743,377,366,1010271910,004191,H447
5731,ROCCASPINALVETI,CH,1195,575,620,3130230760,069076,H448
5732,ROCCASTRADA,GR,8761,4304,4457,2090360200,053021,H449
5733,ROCCAVALDINA,ME,1006,485,521,4190480720,083073,H380
5734,ROCCAVERANO,AT,368,200,168,1010070940,005094,H451
5735,ROCCAVIGNALE,SV,741,373,368,1070740540,009054,H452
5736,ROCCAVIONE,CN,2636,1306,1330,1010271920,004192,H453
5737,ROCCAVIVARA,CB,641,302,339,3140190600,070060,H454
5738,ROCCELLA IONICA,RC,6180,2944,3236,3180670670,080067,H456
5739,ROCCELLA VALDEMONE,ME,567,285,282,4190480730,083074,H455
5740,ROCCHETTA A VOLTURNO,IS,1074,543,531,3140940420,094042,H458
5741,ROCCHETTA BELBO,CN,155,82,73,1010271930,004193,H462
5742,ROCCHETTA DI VARA,SP,674,351,323,1070390250,011025,H461
5743,ROCCHETTA E CROCE,CE,451,232,219,3150200720,061072,H459
5744,ROCCHETTA LIGURE,AL,218,120,98,1010021450,006148,H465
5745,ROCCHETTA NERVINA,IM,293,155,138,1070370480,008051,H460
5746,ROCCHETTA PALAFEA,AT,342,175,167,1010070950,005095,H466
5747,ROCCHETTA SANT'ANTONIO,FG,1683,827,856,3160310400,071042,H467
5748,ROCCHETTA TANARO,AT,1367,675,692,1010070960,005096,H468
5749,RODANO,MI,4627,2294,2333,1030491840,015185,H470
5750,RODDI,CN,1572,788,784,1010271940,004194,H472
5751,RODDINO,CN,409,223,186,1010271950,004195,H473
5752,RODELLO,CN,963,477,486,1010271960,004196,H474
5753,RODENGO SAIANO,BS,9797,4782,5015,1030151540,017163,H477
5754,RODENGO/RODENECK,BZ,1253,646,607,1040140701,021075,H475
5755,RODERO,CO,1259,630,629,1030241860,013197,H478
5756,RODI GARGANICO,FG,3350,1667,1683,3160310410,071043,H480
5757,RODI' MILICI,ME,1947,957,990,4190480740,083075,H479
5758,RODIGO,MN,5153,2554,2599,1030450510,020051,H481
5759,ROE' VOLCIANO,BS,4366,2107,2259,1030151550,017164,H484
5760,ROFRANO,SA,1293,667,626,3150721090,065109,H485
5761,ROGENO,LC,3058,1558,1500,1030980720,097072,H486
5762,ROGGIANO GRAVINA,CS,6820,3304,3516,3180251050,078104,H488
5763,ROGHUDI,RC,971,478,493,3180670680,080068,H489
5764,ROGLIANO,CS,5399,2734,2665,3180251060,078105,H490
5765,ROGNANO,PV,660,330,330,1030571240,018127,H491
5766,ROGNO,BG,3874,1925,1949,1030121720,016182,H492
5767,ROGOLO,SO,561,285,276,1030770560,014056,H493
5768,ROIATE,RM,649,314,335,2120700890,058090,H494
5769,ROIO DEL SANGRO,CH,98,49,49,3130230770,069077,H495
5770,ROISAN,AO,1005,506,499,1020040560,007057,H497
5771,ROLETTO,TO,1988,1008,980,1010812131,001222,H498
5772,ROLO,RE,4016,2041,1975,1080680350,035035,H500
5773,ROMA,RM,2749031,1305497,1443534,2120700900,058091,H501
5774,ROMAGNANO AL MONTE,SA,375,171,204,3150721100,065110,H503
5775,ROMAGNANO SESIA,NO,3677,1761,1916,1010521240,003130,H502
5776,ROMAGNESE,PV,580,308,272,1030571250,018128,H505
5777,ROMANA,SS,497,236,261,4200730600,090061,H507
5778,ROMANENGO,CR,3190,1574,1616,1030260830,019086,H508
5779,ROMANO CANAVESE,TO,2642,1291,1351,1010812140,001223,H511
5780,ROMANO D'EZZELINO,VI,14150,7013,7137,1050900860,024086,H512
5781,ROMANO DI LOMBARDIA,BG,20613,10429,10184,1030121730,016183,H509
5782,ROMANS D'ISONZO,GO,3636,1781,1855,1060350120,031015,H514
5783,ROMBIOLO,VV,4354,2202,2152,3181030310,102031,H516
5784,ROMENO,TN,1397,722,675,1040831440,022155,H517
5785,ROMENTINO,NO,5625,2753,2872,1010521250,003131,H518
5786,ROMETTA,ME,6529,3211,3318,4190480750,083076,H519
5787,RONCA',VR,3752,1900,1852,1050890620,023063,H522
5788,RONCADE,TV,14680,7310,7370,1050840680,026069,H523
5789,RONCADELLE,BS,9282,4617,4665,1030151560,017165,H525
5790,RONCARO,PV,1555,791,764,1030571260,018129,H527
5791,RONCEGNO TERME,TN,2914,1434,1480,1040831450,022156,H528
5792,RONCELLO,MB,4785,2387,2398,1031040375,108055,H529
5793,RONCHI DEI LEGIONARI,GO,11807,5809,5998,1060350130,031016,H531
5794,RONCHI VALSUGANA,TN,454,240,214,1040831460,022157,H532
5795,RONCHIS,UD,1942,961,981,1060850970,030097,H533
5796,RONCIGLIONE,VT,8417,4200,4217,2120910440,056045,H534
5797,RONCO ALL'ADIGE,VR,5946,3021,2925,1050890630,023064,H540
5798,RONCO BIELLESE,BI,1432,729,703,1010960530,096053,H538
5799,RONCO BRIANTINO,MB,3581,1783,1798,1031040380,108038,H537
5800,RONCO CANAVESE,TO,293,157,136,1010812150,001224,H539
5801,RONCO SCRIVIA,GE,4179,2088,2091,1070340490,010049,H536
5802,RONCOBELLO,BG,420,216,204,1030121740,016184,H535
5803,RONCOFERRARO,MN,6802,3346,3456,1030450520,020052,H541
5804,RONCOFREDDO,FC,3379,1725,1654,1080320360,040037,H542
5805,RONCOLA,BG,869,448,421,1030121750,016185,H544
5806,RONDANINA,GE,60,36,24,1070340500,010050,H546
5807,RONDISSONE,TO,1849,951,898,1010812160,001225,H547
5808,RONSECCO,VC,543,250,293,1010881170,002118,H549
5809,RONZO-CHIENIS,TN,992,525,467,1040831471,022135,M303
5810,RONZONE,TN,459,234,225,1040831480,022159,H552
5811,ROPPOLO,BI,861,412,449,1010960540,096054,H553
5812,RORA',TO,227,122,105,1010812170,001226,H554
5813,ROSA',VI,14649,7256,7393,1050900870,024087,H556
5814,ROSARNO,RC,14639,7334,7305,3180670690,080069,H558
5815,ROSASCO,PV,546,269,277,1030571270,018130,H559
5816,ROSATE,MI,5758,2900,2858,1030491870,015188,H560
5817,ROSAZZA,BI,104,48,56,1010960550,096055,H561
5818,ROSCIANO,PE,4038,1965,2073,3130600350,068035,H562
5819,ROSCIGNO,SA,662,336,326,3150721110,065111,H564
5820,ROSE,CS,4164,2061,2103,3180251070,078106,H565
5821,ROSELLO,CH,186,90,96,3130230780,069078,H566
5822,ROSETO CAPO SPULICO,CS,1859,929,930,3180251080,078107,H572
5823,ROSETO DEGLI ABRUZZI,TE,25473,12403,13070,3130790360,067037,F585
5824,ROSETO VALFORTORE,FG,986,478,508,3160310420,071044,H568
5825,ROSIGNANO MARITTIMO,LI,30072,14524,15548,2090420170,049017,H570
5826,ROSIGNANO MONFERRATO,AL,1458,702,756,1010021460,006149,H569
5827,ROSOLINA,RO,6221,3122,3099,1050710400,029040,H573
5828,ROSOLINI,SR,20639,10202,10437,4190760160,089016,H574
5829,ROSORA,AN,1858,911,947,2110030400,042040,H575
5830,ROSSA,VC,175,97,78,1010881200,002121,H577
5831,ROSSANA,CN,820,430,390,1010271970,004197,H578
5832,ROSSANO VENETO,VI,8183,4064,4119,1050900880,024088,H580
5833,ROSSIGLIONE,GE,2560,1236,1324,1070340510,010051,H581
5834,ROSTA,TO,5056,2469,2587,1010812190,001228,H583
5835,ROTA D'IMAGNA,BG,895,443,452,1030121760,016186,H584
5836,ROTA GRECA,CS,1011,508,503,3180251100,078109,H585
5837,ROTELLA,AP,815,409,406,2110060640,044065,H588
5838,ROTELLO,CB,1122,569,553,3140190610,070061,H589
5839,ROTONDA,PZ,3225,1631,1594,3170640690,076070,H590
5840,ROTONDELLA,MT,2448,1180,1268,3170470220,077023,H591
5841,ROTONDI,AV,3424,1725,1699,3150080790,064080,H592
5842,ROTTOFRENO,PC,12200,5999,6201,1080610390,033039,H593
5843,ROTZO,VI,641,317,324,1050900890,024089,H594
5844,ROURE,TO,765,371,394,1010812191,001227,H555
5845,ROVASENDA,VC,912,438,474,1010881210,002122,H364
5846,ROVATO,BS,19198,9840,9358,1030151570,017166,H598
5847,ROVEGNO,GE,492,274,218,1070340520,010052,H599
5848,ROVELLASCA,CO,7923,3908,4015,1030241890,013201,H601
5849,ROVELLO PORRO,CO,6209,3052,3157,1030241900,013202,H602
5850,ROVERBELLA,MN,8670,4327,4343,1030450530,020053,H604
5851,ROVERCHIARA,VR,2582,1327,1255,1050890640,023065,H606
5852,ROVERE' DELLA LUNA,TN,1638,834,804,1040831490,022160,H607
5853,ROVERE' VERONESE,VR,2094,1069,1025,1050890660,023067,H608
5854,ROVEREDO DI GUA',VR,1618,815,803,1050890650,023066,H610
5855,ROVEREDO IN PIANO,PN,5860,2836,3024,1060930360,093036,H609
5856,ROVERETO,TN,39766,19052,20714,1040831500,022161,H612
5857,ROVESCALA,PV,845,418,427,1030571280,018131,H614
5858,ROVETTA,BG,4110,2016,2094,1030121770,016187,H615
5859,ROVIANO,RM,1256,590,666,2120700910,058092,H618
5860,ROVIGO,RO,50190,24174,26016,1050710410,029041,H620
5861,ROVITO,CS,3025,1526,1499,3180251110,078110,H621
5862,ROVOLON,PD,4878,2441,2437,1050540710,028071,H622
5863,ROZZANO,MI,41435,20084,21351,1030491880,015189,H623
5864,RUBANO,PD,16794,8125,8669,1050540720,028072,H625
5865,RUBIANA,TO,2391,1181,1210,1010812200,001229,H627
5866,RUBIERA,RE,14765,7270,7495,1080680360,035036,H628
5867,RUDA,UD,2790,1357,1433,1060850980,030098,H629
5868,RUDIANO,BS,5857,2976,2881,1030151580,017167,H630
5869,RUEGLIO,TO,788,393,395,1010812210,001230,H631
5870,RUFFANO,LE,9353,4500,4853,3160410630,075064,H632
5871,RUFFIA,CN,364,196,168,1010271980,004198,H633
5872,RUFFRE'-MENDOLA,TN,427,224,203,1040831510,022162,H634
5873,RUFINA,FI,7118,3522,3596,2090300370,048037,H635
5874,RUINAS,OR,621,299,322,4200950440,095044,F271
5875,RUMO,TN,798,406,392,1040831520,022163,H639
5876,RUOTI,PZ,3345,1659,1686,3170640700,076071,H641
5877,RUSSI,RA,12107,5977,6130,1080660160,039016,H642
5878,RUTIGLIANO,BA,18262,9011,9251,3160090360,072037,H643
5879,RUTINO,SA,765,399,366,3150721120,065112,H644
5880,RUVIANO,CE,1716,833,883,3150200730,061073,H165
5881,RUVO DEL MONTE,PZ,1001,491,510,3170640710,076072,H646
5882,RUVO DI PUGLIA,BA,24520,11959,12561,3160090370,072038,H645
5883,SABAUDIA,LT,19666,10015,9651,2120400240,059024,H647
5884,SABBIO CHIESE,BS,3932,1994,1938,1030151590,017168,H650
5885,SABBIONETA,MN,4100,2041,2059,1030450540,020054,H652
5886,SACCO,SA,443,214,229,3150721130,065113,H654
5887,SACCOLONGO,PD,4900,2438,2462,1050540730,028073,H655
5888,SACILE,PN,19877,9673,10204,1060930370,093037,H657
5889,SACROFANO,RM,7403,3652,3751,2120700920,058093,H658
5890,SADALI,SU,873,435,438,4201110580,111058,H659
5891,SAGAMA,OR,195,98,97,4200950446,095086,H661
5892,SAGLIANO MICCA,BI,1540,740,800,1010960560,096056,H662
5893,SAGRADO,GO,2168,1059,1109,1060350140,031017,H665
5894,SAGRON MIS,TN,178,92,86,1040831530,022164,H666
5895,SAINT-CHRISTOPHE,AO,3484,1749,1735,1020040570,007058,H669
5896,SAINT-DENIS,AO,371,189,182,1020040580,007059,H670
5897,SAINT-MARCEL,AO,1312,644,668,1020040590,007060,H671
5898,SAINT-NICOLAS,AO,321,170,151,1020040600,007061,H672
5899,SAINT-OYEN,AO,198,89,109,1020040610,007062,H673
5900,SAINT-PIERRE,AO,3240,1607,1633,1020040620,007063,H674
5901,SAINT-RHEMY-EN-BOSSES,AO,330,177,153,1020040630,007064,H675
5902,SAINT-VINCENT,AO,4451,2163,2288,1020040640,007065,H676
5903,SALA BAGANZA,PR,5802,2962,2840,1080560310,034031,H682
5904,SALA BIELLESE,BI,571,275,296,1010960570,096057,H681
5905,SALA BOLOGNESE,BO,8462,4211,4251,1080130500,037050,H678
5906,SALA COMACINA,CO,481,243,238,1030241910,013203,H679
5907,SALA CONSILINA,SA,12258,5951,6307,3150721140,065114,H683
5908,SALA MONFERRATO,AL,340,163,177,1010021470,006150,H677
5909,SALANDRA,MT,2575,1273,1302,3170470230,077024,H687
5910,SALAPARUTA,TP,1595,760,835,4190820180,081017,H688
5911,SALARA,RO,1053,501,552,1050710420,029042,H689
5912,SALASCO,VC,207,114,93,1010881250,002126,H690
5913,SALASSA,TO,1792,879,913,1010812230,001231,H691
5914,SALBERTRAND,TO,605,318,287,1010812231,001232,H684
5915,SALCEDO,VI,1024,513,511,1050900900,024090,F810
5916,SALCITO,CB,631,327,304,3140190620,070062,H693
5917,SALE,AL,3916,1910,2006,1010021480,006151,H694
5918,SALE DELLE LANGHE,CN,472,243,229,1010271990,004199,H695
5919,SALE MARASINO,BS,3290,1614,1676,1030151600,017169,H699
5920,SALE SAN GIOVANNI,CN,154,79,75,1010272000,004200,H704
5921,SALEMI,TP,10082,5027,5055,4190820190,081018,H700
5922,SALENTO,SA,1802,886,916,3150721150,065115,H686
5923,SALERANO CANAVESE,TO,458,227,231,1010812240,001233,H702
5924,SALERANO SUL LAMBRO,LO,2602,1281,1321,1030990460,098046,H701
5925,SALERNO,SA,128136,60218,67918,3150721160,065116,H703
5926,SALGAREDA,TV,6567,3312,3255,1050840690,026070,H706
5927,SALI VERCELLESE,VC,99,48,51,1010881260,002127,H707
5928,SALICE SALENTINO,LE,7838,3777,4061,3160410640,075065,H708
5929,SALICETO,CN,1184,575,609,1010272010,004201,H710
5930,SALISANO,RI,498,238,260,2120690610,057063,H713
5931,SALIZZOLE,VR,3759,1943,1816,1050890670,023068,H714
5932,SALLE,PE,270,136,134,3130600360,068036,H715
5933,SALMOUR,CN,716,384,332,1010272020,004202,H716
5934,SALO',BS,10448,4904,5544,1030151610,017170,H717
5935,SALORNO SULLA STRADA DEL VINO/SALURN AN DER WEINSTRASSE,BZ,3768,1893,1875,1040140710,021076,H719
5936,SALSOMAGGIORE TERME,PR,19906,9869,10037,1080560320,034032,H720
5937,SALTRIO,VA,2987,1441,1546,1030860991,012117,H723
5938,SALUDECIO,RN,3048,1545,1503,1081010150,099015,H724
5939,SALUGGIA,VC,3777,1840,1937,1010881270,002128,H725
5940,SALUSSOLA,BI,1868,959,909,1010960580,096058,H726
5941,SALUZZO,CN,17433,8597,8836,1010272030,004203,H727
5942,SALVE,LE,4485,2147,2338,3160410650,075066,H729
5943,SALVIROLA,CR,1162,578,584,1030260840,019087,H731
5944,SALVITELLE,SA,496,240,256,3150721170,065117,H732
5945,SALZA DI PINEROLO,TO,74,48,26,1010812250,001234,H734
5946,SALZA IRPINA,AV,723,360,363,3150080800,064081,H733
5947,SALZANO,VE,12802,6363,6439,1050870320,027032,H735
5948,SAMARATE,VA,16037,7931,8106,1030861000,012118,H736
5949,SAMASSI,SU,4836,2367,2469,4201110590,111059,H738
5950,SAMATZAI,SU,1558,772,786,4201110600,111060,H739
5951,SAMBUCA DI SICILIA,AG,5418,2690,2728,4190010340,084034,H743
5952,SAMBUCA PISTOIESE,PT,1446,729,717,2090630170,047018,H744
5953,SAMBUCI,RM,839,411,428,2120700930,058094,H745
5954,SAMBUCO,CN,86,42,44,1010272040,004204,H746
5955,SAMMICHELE DI BARI,BA,6074,2941,3133,3160090380,072039,H749
5956,SAMO,RC,737,355,382,3180670700,080070,H013
5957,SAMOLACO,SO,2886,1408,1478,1030770570,014057,H752
5958,SAMONE,TN,544,286,258,1040831540,022165,H754
5959,SAMONE,TN,544,286,258,1010812260,001235,H753
5960,SAMONE,TO,1468,732,736,1040831540,022165,H754
5961,SAMONE,TO,1468,732,736,1010812260,001235,H753
5962,SAMPEYRE,CN,988,499,489,1010272050,004205,H755
5963,SAMUGHEO,OR,2796,1383,1413,4200950450,095045,H756
5964,SAN BARTOLOMEO AL MARE,IM,2943,1386,1557,1070370490,008052,H763
5965,SAN BARTOLOMEO IN GALDO,BN,4417,2158,2259,3150110560,062057,H764
5966,SAN BARTOLOMEO VAL CAVARGNA,CO,967,470,497,1030241920,013204,H760
5967,SAN BASILE,CS,954,449,505,3180251120,078111,H765
5968,SAN BASILIO,SU,1150,593,557,4201110610,111061,H766
5969,SAN BASSANO,CR,2105,1004,1101,1030260850,019088,H767
5970,SAN BELLINO,RO,1035,530,505,1050710430,029043,H768
5971,SAN BENEDETTO BELBO,CN,151,76,75,1010272060,004206,H770
5972,SAN BENEDETTO DEI MARSI,AQ,3746,1868,1878,3130380850,066085,H772
5973,SAN BENEDETTO DEL TRONTO,AP,47000,22250,24750,2110060650,044066,H769
5974,SAN BENEDETTO IN PERILLIS,AQ,98,53,45,3130380860,066086,H773
5975,SAN BENEDETTO PO,MN,6716,3346,3370,1030450550,020055,H771
5976,SAN BENEDETTO ULLANO,CS,1390,690,700,3180251130,078112,H774
5977,SAN BENEDETTO VAL DI SAMBRO,BO,4202,2161,2041,1080130510,037051,G566
5978,SAN BENIGNO CANAVESE,TO,5999,2960,3039,1010812270,001236,H775
5979,SAN BERNARDINO VERBANO,VB,1256,634,622,1011020610,103061,H777
5980,SAN BIAGIO DELLA CIMA,IM,1246,603,643,1070370500,008053,H780
5981,SAN BIAGIO DI CALLALTA,TV,12761,6392,6369,1050840700,026071,H781
5982,SAN BIAGIO PLATANI,AG,2919,1374,1545,4190010350,084035,H778
5983,SAN BIAGIO SARACINISCO,FR,313,150,163,2120330600,060061,H779
5984,SAN BIASE,CB,134,65,69,3140190630,070063,H782
5985,SAN BONIFACIO,VR,21354,10693,10661,1050890680,023069,H783
5986,SAN BUONO,CH,869,456,413,3130230790,069079,H784
5987,SAN CALOGERO,VV,3942,1976,1966,3181030320,102032,H785
5988,SAN CANDIDO/INNICHEN,BZ,3405,1677,1728,1040140720,021077,H786
5989,SAN CANZIAN D'ISONZO,GO,6040,2973,3067,1060350150,031018,H787
5990,SAN CARLO CANAVESE,TO,4010,1955,2055,1010812280,001237,H789
5991,SAN CASCIANO DEI BAGNI,SI,1516,749,767,2090750270,052027,H790
5992,SAN CASCIANO IN VAL DI PESA,FI,16643,8020,8623,2090300380,048038,H791
5993,SAN CASSIANO,LE,1963,981,982,3160410661,075095,M264
5994,SAN CATALDO,CL,21212,10264,10948,4190180160,085016,H792
5995,SAN CESAREO,RM,15960,7994,7966,2120700931,058119,M295
5996,SAN CESARIO DI LECCE,LE,7912,3782,4130,3160410670,075068,H793
5997,SAN CESARIO SUL PANARO,MO,6574,3277,3297,1080500350,036036,H794
5998,SAN CHIRICO NUOVO,PZ,1206,603,603,3170640720,076073,H795
5999,SAN CHIRICO RAPARO,PZ,953,490,463,3170640730,076074,H796
6000,SAN CIPIRELLO,PA,4998,2440,2558,4190550610,082063,H797
6001,SAN CIPRIANO D'AVERSA,CE,13130,6566,6564,3150200740,061074,H798
6002,SAN CIPRIANO PICENTINO,SA,6516,3190,3326,3150721180,065118,H800
6003,SAN CIPRIANO PO,PV,465,242,223,1030571300,018133,H799
6004,SAN CLEMENTE,RN,5671,2813,2858,1081010160,099016,H801
6005,SAN COLOMBANO AL LAMBRO,MI,7239,3576,3663,1030491900,015191,H803
6006,SAN COLOMBANO BELMONTE,TO,358,176,182,1010812290,001238,H804
6007,SAN COLOMBANO CERTENOLI,GE,2563,1306,1257,1070340530,010053,H802
6008,SAN CONO,CT,2440,1217,1223,4190210390,087040,H805
6009,SAN COSMO ALBANESE,CS,578,272,306,3180251140,078113,H806
6010,SAN COSTANTINO ALBANESE,PZ,624,304,320,3170640740,076075,H808
6011,SAN COSTANTINO CALABRO,VV,2089,1024,1065,3181030330,102033,H807
6012,SAN COSTANZO,PU,4554,2290,2264,2110590510,041051,H809
6013,SAN CRISTOFORO,AL,542,260,282,1010021490,006152,H810
6014,SAN DAMIANO AL COLLE,PV,629,322,307,1030571310,018134,H814
6015,SAN DAMIANO D'ASTI,AT,8075,3973,4102,1010070970,005097,H811
6016,SAN DAMIANO MACRA,CN,414,215,199,1010272070,004207,H812
6017,SAN DANIELE DEL FRIULI,UD,7914,3812,4102,1060850990,030099,H816
6018,SAN DANIELE PO,CR,1291,649,642,1030260860,019089,H815
6019,SAN DEMETRIO CORONE,CS,3122,1494,1628,3180251150,078114,H818
6020,SAN DEMETRIO NE' VESTINI,AQ,1902,935,967,3130380870,066087,H819
6021,SAN DIDERO,TO,516,256,260,1010812300,001239,H820
6022,SAN DONA' DI PIAVE,VE,41664,20014,21650,1050870330,027033,H823
6023,SAN DONACI,BR,6216,3005,3211,3160160130,074013,H822
6024,SAN DONATO DI LECCE,LE,5484,2556,2928,3160410680,075069,H826
6025,SAN DONATO DI NINEA,CS,1131,538,593,3180251160,078115,H825
6026,SAN DONATO MILANESE,MI,32008,15529,16479,1030491910,015192,H827
6027,SAN DONATO VAL DI COMINO,FR,1897,916,981,2120330610,060062,H824
6028,SAN DORLIGO DELLA VALLE-DOLINA,TS,5693,2832,2861,1060920040,032004,D324
6029,SAN FELE,PZ,2655,1298,1357,3170640750,076076,H831
6030,SAN FELICE A CANCELLO,CE,16963,8365,8598,3150200750,061075,H834
6031,SAN FELICE CIRCEO,LT,10100,5229,4871,2120400250,059025,H836
6032,SAN FELICE DEL BENACO,BS,3465,1685,1780,1030151620,017171,H838
6033,SAN FELICE DEL MOLISE,CB,560,281,279,3140190640,070064,H833
6034,SAN FELICE SUL PANARO,MO,10679,5304,5375,1080500360,036037,H835
6035,SAN FERDINANDO,RC,4488,2441,2047,3180670701,080097,M277
6036,SAN FERDINANDO DI PUGLIA,BT,13713,6846,6867,3161060070,110007,H839
6037,SAN FERMO DELLA BATTAGLIA,CO,7799,3778,4021,1030241940,013206,H840
6038,SAN FILI,CS,2531,1272,1259,3180251170,078116,H841
6039,SAN FILIPPO DEL MELA,ME,6791,3347,3444,4190480760,083077,H842
6040,SAN FIOR,TV,6843,3393,3450,1050840710,026072,H843
6041,SAN FIORANO,LO,1851,930,921,1030990470,098047,H844
6042,SAN FLORIANO DEL COLLIO,GO,742,367,375,1060350160,031019,H845
6043,SAN FLORO,CZ,689,341,348,3180221050,079108,H846
6044,SAN FRANCESCO AL CAMPO,TO,4847,2381,2466,1010812310,001240,H847
6045,SAN FRATELLO,ME,3323,1645,1678,4190480770,083078,H850
6046,SAN GAVINO MONREALE,SU,8160,3972,4188,4201110620,111062,H856
6047,SAN GEMINI,TR,4769,2289,2480,2100800290,055029,H857
6048,SAN GENESIO ATESINO/JENESIEN,BZ,3048,1551,1497,1040140740,021079,H858
6049,SAN GENESIO ED UNITI,PV,4010,1955,2055,1030571320,018135,H859
6050,SAN GENNARO VESUVIANO,,12031,6239,5792,3150510660,063066,H860
6051,SAN GERMANO CHISONE,TO,1691,866,825,1010812320,001242,H862
6052,SAN GERMANO VERCELLESE,VC,1473,733,740,1010881300,002131,H861
6053,SAN GERVASIO BRESCIANO,BS,2685,1348,1337,1030151630,017172,H865
6054,SAN GIACOMO DEGLI SCHIAVONI,CB,1392,676,716,3140190650,070065,H867
6055,SAN GIACOMO DELLE SEGNATE,MN,1462,720,742,1030450560,020056,H870
6056,SAN GIACOMO FILIPPO,SO,369,189,180,1030770580,014058,H868
6057,SAN GIACOMO VERCELLESE,VC,277,134,143,1010881301,002035,B952
6058,SAN GILLIO,TO,3217,1557,1660,1010812330,001243,H873
6059,SAN GIMIGNANO,SI,7487,3790,3697,2090750280,052028,H875
6060,SAN GINESIO,MC,3114,1555,1559,2110440460,043046,H876
6061,SAN GIORGIO A CREMANO,,43057,20308,22749,3150510670,063067,H892
6062,SAN GIORGIO A LIRI,FR,3043,1509,1534,2120330620,060063,H880
6063,SAN GIORGIO ALBANESE,CS,1336,652,684,3180251190,078118,H881
6064,SAN GIORGIO BIGARELLO,MN,11812,5863,5949,1030450570,020057,H883
6065,SAN GIORGIO CANAVESE,TO,2534,1250,1284,1010812340,001244,H890
6066,SAN GIORGIO DEL SANNIO,BN,9815,4724,5091,3150110570,062058,H894
6067,SAN GIORGIO DELLA RICHINVELDA,PN,4531,2359,2172,1060930380,093038,H891
6068,SAN GIORGIO DELLE PERTICHE,PD,10130,5069,5061,1050540750,028075,H893
6069,SAN GIORGIO DI LOMELLINA,PV,1013,513,500,1030571330,018136,H885
6070,SAN GIORGIO DI NOGARO,UD,7280,3626,3654,1060851000,030100,H895
6071,SAN GIORGIO DI PIANO,BO,9163,4493,4670,1080130520,037052,H896
6072,SAN GIORGIO IN BOSCO,PD,6389,3223,3166,1050540760,028076,H897
6073,SAN GIORGIO IONICO,TA,14355,6935,7420,3160780240,073024,H882
6074,SAN GIORGIO LA MOLARA,BN,2821,1426,1395,3150110580,062059,H898
6075,SAN GIORGIO LUCANO,MT,1078,548,530,3170470240,077025,H888
6076,SAN GIORGIO MONFERRATO,AL,1201,586,615,1010021500,006153,H878
6077,SAN GIORGIO MORGETO,RC,2965,1425,1540,3180670710,080071,H889
6078,SAN GIORGIO PIACENTINO,PC,5605,2748,2857,1080610400,033040,H887
6079,SAN GIORGIO SCARAMPI,AT,97,53,44,1010070980,005098,H899
6080,SAN GIORGIO SU LEGNANO,MI,6697,3295,3402,1030491930,015194,H884
6081,SAN GIORIO DI SUSA,TO,987,482,505,1010812350,001245,H900
6082,SAN GIOVANNI A PIRO,SA,3648,1814,1834,3150721190,065119,H907
6083,SAN GIOVANNI AL NATISONE,UD,6052,3095,2957,1060851010,030101,H906
6084,SAN GIOVANNI BIANCO,BG,4625,2337,2288,1030121780,016188,H910
6085,SAN GIOVANNI DEL DOSSO,MN,1245,622,623,1030450580,020058,H912
6086,SAN GIOVANNI DI FASSA,TN,3576,1774,1802,1040831618,022250,M390
6087,SAN GIOVANNI DI GERACE,RC,419,202,217,3180670720,080072,H903
6088,SAN GIOVANNI GEMINI,AG,7604,3784,3820,4190010360,084036,H914
6089,SAN GIOVANNI ILARIONE,VR,4898,2477,2421,1050890690,023070,H916
6090,SAN GIOVANNI IN CROCE,CR,1889,917,972,1030260870,019090,H918
6091,SAN GIOVANNI IN FIORE,CS,16106,7824,8282,3180251200,078119,H919
6092,SAN GIOVANNI IN GALDO,CB,537,259,278,3140190660,070066,H920
6093,SAN GIOVANNI IN MARIGNANO,RN,9451,4595,4856,1081010170,099017,H921
6094,SAN GIOVANNI IN PERSICETO,BO,27869,13591,14278,1080130530,037053,G467
6095,SAN GIOVANNI INCARICO,FR,3094,1519,1575,2120330630,060064,H917
6096,SAN GIOVANNI LA PUNTA,CT,23649,11361,12288,4190210400,087041,H922
6097,SAN GIOVANNI LIPIONI,CH,139,68,71,3130230800,069080,H923
6098,SAN GIOVANNI LUPATOTO,VR,25334,12405,12929,1050890700,023071,H924
6099,SAN GIOVANNI ROTONDO,FG,26382,12908,13474,3160310440,071046,H926
6100,SAN GIOVANNI SUERGIU,SU,5689,2849,2840,4201110630,111063,G287
6101,SAN GIOVANNI TEATINO,CH,14258,6961,7297,3130230810,069081,D690
6102,SAN GIOVANNI VALDARNO,AR,16644,7929,8715,2090050330,051033,H901
6103,SAN GIULIANO DEL SANNIO,CB,958,493,465,3140190670,070067,H928
6104,SAN GIULIANO DI PUGLIA,CB,989,482,507,3140190680,070068,H929
6105,SAN GIULIANO MILANESE,MI,39253,19546,19707,1030491940,015195,H930
6106,SAN GIULIANO TERME,PI,30836,15018,15818,2090620300,050031,A562
6107,SAN GIUSEPPE JATO,PA,8204,4022,4182,4190550620,082064,H933
6108,SAN GIUSEPPE VESUVIANO,,30045,15519,14526,3150510680,063068,H931
6109,SAN GIUSTINO,PG,10956,5361,5595,2100580440,054044,H935
6110,SAN GIUSTO CANAVESE,TO,3261,1582,1679,1010812360,001246,H936
6111,SAN GODENZO,FI,1060,525,535,2090300390,048039,H937
6112,SAN GREGORIO D'IPPONA,VV,2521,1293,1228,3181030340,102034,H941
6113,SAN GREGORIO DA SASSOLA,RM,1457,733,724,2120700940,058095,H942
6114,SAN GREGORIO DI CATANIA,CT,11487,5501,5986,4190210410,087042,H940
6115,SAN GREGORIO MAGNO,SA,3990,1942,2048,3150721200,065120,H943
6116,SAN GREGORIO MATESE,CE,888,440,448,3150200760,061076,H939
6117,SAN GREGORIO NELLE ALPI,BL,1552,774,778,1050100450,025045,H938
6118,SAN LAZZARO DI SAVENA,BO,32606,15599,17007,1080130540,037054,H945
6119,SAN LEO,RN,2818,1425,1393,1081010175,099025,H949
6120,SAN LEONARDO,UD,1045,535,510,1060851020,030102,H951
6121,SAN LEONARDO IN PASSIRIA/ST. LEONHARD IN PASSEIER,BZ,3615,1842,1773,1040140750,021080,H952
6122,SAN LEUCIO DEL SANNIO,BN,2949,1451,1498,3150110590,062060,H953
6123,SAN LORENZELLO,BN,2125,1070,1055,3150110600,062061,H955
6124,SAN LORENZO,RC,2271,1120,1151,3180670730,080073,H959
6125,SAN LORENZO AL MARE,IM,1226,597,629,1070370510,008054,H957
6126,SAN LORENZO BELLIZZI,CS,551,274,277,3180251210,078120,H961
6127,SAN LORENZO DEL VALLO,CS,3098,1564,1534,3180251220,078121,H962
6128,SAN LORENZO DI SEBATO/ST. LORENZEN,BZ,3845,1924,1921,1040140760,021081,H956
6129,SAN LORENZO DORSINO,TN,1572,785,787,1040831555,022231,M345
6130,SAN LORENZO IN CAMPO,PU,3201,1540,1661,2110590540,041054,H958
6131,SAN LORENZO ISONTINO,GO,1506,754,752,1060350161,031020,H964
6132,SAN LORENZO MAGGIORE,BN,1918,953,965,3150110610,062062,H967
6133,SAN LORENZO NUOVO,VT,1994,980,1014,2120910460,056047,H969
6134,SAN LUCA,RC,3482,1707,1775,3180670740,080074,H970
6135,SAN LUCIDO,CS,6005,2968,3037,3180251230,078122,H971
6136,SAN LUPO,BN,723,365,358,3150110620,062063,H973
6137,SAN MANGO D'AQUINO,CZ,1440,700,740,3180221070,079110,H976
6138,SAN MANGO PIEMONTE,SA,2610,1298,1312,3150721210,065121,H977
6139,SAN MANGO SUL CALORE,AV,1094,565,529,3150080810,064082,H975
6140,SAN MARCELLINO,CE,14643,7326,7317,3150200770,061077,H978
6141,SAN MARCELLO,AN,2026,995,1031,2110030410,042041,H979
6142,SAN MARCELLO PITEGLIO,PT,7671,3652,4019,2090630185,047024,M377
6143,SAN MARCO ARGENTANO,CS,6942,3452,3490,3180251240,078123,H981
6144,SAN MARCO D'ALUNZIO,ME,1812,869,943,4190480780,083079,H982
6145,SAN MARCO DEI CAVOTI,BN,3014,1446,1568,3150110630,062064,H984
6146,SAN MARCO EVANGELISTA,CE,6456,3190,3266,3150200771,061104,F043
6147,SAN MARCO IN LAMIS,FG,12789,6292,6497,3160310450,071047,H985
6148,SAN MARCO LA CATOLA,FG,890,442,448,3160310460,071048,H986
6149,SAN MARTINO AL TAGLIAMENTO,PN,1453,726,727,1060930390,093039,H999
6150,SAN MARTINO ALFIERI,AT,660,346,314,1010070990,005099,H987
6151,SAN MARTINO BUON ALBERGO,VR,16021,7976,8045,1050890720,023073,I003
6152,SAN MARTINO CANAVESE,TO,811,396,415,1010812370,001247,H997
6153,SAN MARTINO D'AGRI,PZ,688,352,336,3170640760,076077,H994
6154,SAN MARTINO DALL'ARGINE,MN,1598,785,813,1030450590,020059,I005
6155,SAN MARTINO DEL LAGO,CR,397,198,199,1030260880,019091,I007
6156,SAN MARTINO DI FINITA,CS,968,472,496,3180251250,078124,H992
6157,SAN MARTINO DI LUPARI,PD,13184,6561,6623,1050540770,028077,I008
6158,SAN MARTINO DI VENEZZE,RO,3758,1846,1912,1050710440,029044,H996
6159,SAN MARTINO IN BADIA/ST. MARTIN IN THURN,BZ,1761,895,866,1040140770,021082,H988
6160,SAN MARTINO IN PASSIRIA/ST. MARTIN IN PASSEIER,BZ,3235,1620,1615,1040140771,021083,H989
6161,SAN MARTINO IN PENSILIS,CB,4531,2233,2298,3140190690,070069,H990
6162,SAN MARTINO IN RIO,RE,8194,4083,4111,1080680370,035037,I011
6163,SAN MARTINO IN STRADA,LO,3710,1865,1845,1030990480,098048,I012
6164,SAN MARTINO SANNITA,BN,1158,583,575,3150110640,062065,I002
6165,SAN MARTINO SICCOMARIO,PV,6326,3109,3217,1030571340,018137,I014
6166,SAN MARTINO SULLA MARRUCINA,CH,832,419,413,3130230820,069082,H991
6167,SAN MARTINO VALLE CAUDINA,AV,4805,2382,2423,3150080820,064083,I016
6168,SAN MARZANO DI SAN GIUSEPPE,TA,8963,4481,4482,3160780250,073025,I018
6169,SAN MARZANO OLIVETO,AT,989,502,487,1010071000,005100,I017
6170,SAN MARZANO SUL SARNO,SA,10325,5156,5169,3150721220,065122,I019
6171,SAN MASSIMO,CB,802,433,369,3140190700,070070,I023
6172,SAN MAURIZIO CANAVESE,TO,10228,5053,5175,1010812380,001248,I024
6173,SAN MAURIZIO D'OPAGLIO,NO,2994,1432,1562,1010521270,003133,I025
6174,SAN MAURO CASTELVERDE,PA,1384,694,690,4190550630,082065,I028
6175,SAN MAURO CILENTO,SA,863,438,425,3150721230,065123,I031
6176,SAN MAURO DI SALINE,VR,580,298,282,1050890730,023074,H712
6177,SAN MAURO FORTE,MT,1287,660,627,3170470250,077026,I029
6178,SAN MAURO LA BRUCA,SA,542,263,279,3150721240,065124,I032
6179,SAN MAURO MARCHESATO,KR,1952,947,1005,3180970200,101020,I026
6180,SAN MAURO PASCOLI,FC,12192,6012,6180,1080320400,040041,I027
6181,SAN MAURO TORINESE,TO,18635,9031,9604,1010812390,001249,I030
6182,SAN MICHELE AL TAGLIAMENTO,VE,11431,5558,5873,1050870340,027034,I040
6183,SAN MICHELE ALL'ADIGE,TN,4010,2016,1994,1040831560,022167,I042
6184,SAN MICHELE DI GANZARIA,CT,2922,1432,1490,4190210420,087043,I035
6185,SAN MICHELE DI SERINO,AV,2435,1227,1208,3150080830,064084,I034
6186,SAN MICHELE MONDOVI',CN,1810,886,924,1010272100,004210,I037
6187,SAN MICHELE SALENTINO,BR,6134,3009,3125,3160160140,074014,I045
6188,SAN MINIATO,PI,27767,13574,14193,2090620310,050032,I046
6189,SAN NAZZARO,BN,862,431,431,3150110641,062066,I049
6190,SAN NAZZARO SESIA,NO,731,384,347,1010521280,003134,I052
6191,SAN NAZZARO VAL CAVARGNA,CO,278,146,132,1030241950,013207,I051
6192,SAN NICANDRO GARGANICO,FG,13986,6701,7285,3160310470,071049,I054
6193,SAN NICOLA ARCELLA,CS,1949,984,965,3180251260,078125,I060
6194,SAN NICOLA BARONIA,AV,757,371,386,3150080840,064085,I061
6195,SAN NICOLA DA CRISSA,VV,1244,628,616,3181030350,102035,I058
6196,SAN NICOLA DELL'ALTO,KR,721,355,366,3180970210,101021,I057
6197,SAN NICOLA LA STRADA,CE,22232,11034,11198,3150200780,061078,I056
6198,SAN NICOLA MANFREDI,BN,3524,1744,1780,3150110650,062067,I062
6199,SAN NICOLO' D'ARCIDANO,OR,2526,1253,1273,4200950460,095046,A368
6200,SAN NICOLO' DI COMELICO,BL,377,193,184,1050100460,025046,I063
6201,SAN NICOLO' GERREI,SU,718,374,344,4201110640,111064,G383
6202,SAN PANCRAZIO SALENTINO,BR,9386,4535,4851,3160160150,074015,I066
6203,SAN PANCRAZIO/ST. PANKRAZ,BZ,1517,780,737,1040140772,021084,I065
6204,SAN PAOLO,BS,4417,2208,2209,1030151631,017138,G407
6205,SAN PAOLO ALBANESE,PZ,220,100,120,3170640761,076020,B906
6206,SAN PAOLO BEL SITO,,3370,1657,1713,3150510690,063069,I073
6207,SAN PAOLO D'ARGON,BG,5802,2908,2894,1030121800,016189,B310
6208,SAN PAOLO DI CIVITATE,FG,5563,2732,2831,3160310480,071050,I072
6209,SAN PAOLO DI JESI,AN,885,430,455,2110030420,042042,I071
6210,SAN PAOLO SOLBRITO,AT,1160,577,583,1010071010,005101,I076
6211,SAN PELLEGRINO TERME,BG,4704,2272,2432,1030121810,016190,I079
6212,SAN PIER D'ISONZO,GO,1993,1017,976,1060350170,031021,I082
6213,SAN PIER NICETO,ME,2632,1279,1353,4190480790,083080,I084
6214,SAN PIERO PATTI,ME,2612,1253,1359,4190480800,083081,I086
6215,SAN PIETRO A MAIDA,CZ,3812,1899,1913,3180221110,079114,I093
6216,SAN PIETRO AL NATISONE,UD,2086,1040,1046,1060851030,030103,I092
6217,SAN PIETRO AL TANAGRO,SA,1659,819,840,3150721250,065125,I089
6218,SAN PIETRO APOSTOLO,CZ,1561,759,802,3180221120,079115,I095
6219,SAN PIETRO AVELLANA,IS,439,208,231,3140940430,094043,I096
6220,SAN PIETRO CLARENZA,CT,8229,4077,4152,4190210430,087044,I098
6221,SAN PIETRO DI CADORE,BL,1542,774,768,1050100470,025047,I088
6222,SAN PIETRO DI CARIDA',RC,1022,478,544,3180670750,080075,I102
6223,SAN PIETRO DI FELETTO,TV,5141,2470,2671,1050840720,026073,I103
6224,SAN PIETRO DI MORUBIO,VR,3054,1589,1465,1050890740,023075,I105
6225,SAN PIETRO IN AMANTEA,CS,481,241,240,3180251270,078126,I108
6226,SAN PIETRO IN CARIANO,VR,12888,6204,6684,1050890750,023076,I109
6227,SAN PIETRO IN CASALE,BO,12661,6311,6350,1080130550,037055,I110
6228,SAN PIETRO IN CERRO,PC,794,389,405,1080610410,033041,G788
6229,SAN PIETRO IN GU,PD,4257,2113,2144,1050540780,028078,I107
6230,SAN PIETRO IN GUARANO,CS,3434,1712,1722,3180251280,078127,I114
6231,SAN PIETRO IN LAMA,LE,3390,1592,1798,3160410700,075071,I115
6232,SAN PIETRO INFINE,CE,859,425,434,3150200790,061079,I113
6233,SAN PIETRO MOSEZZO,NO,1971,989,982,1010521290,003135,I116
6234,SAN PIETRO MUSSOLINO,VI,1544,799,745,1050900940,024094,I117
6235,SAN PIETRO VAL LEMINA,TO,1457,742,715,1010812400,001250,I090
6236,SAN PIETRO VERNOTICO,BR,13156,6300,6856,3160160160,074016,I119
6237,SAN PIETRO VIMINARIO,PD,3048,1551,1497,1050540790,028079,I120
6238,SAN PIO DELLE CAMERE,AQ,666,330,336,3130380880,066088,I121
6239,SAN POLO D'ENZA,RE,6146,3018,3128,1080680380,035038,I123
6240,SAN POLO DEI CAVALIERI,RM,2789,1429,1360,2120700950,058096,I125
6241,SAN POLO DI PIAVE,TV,4914,2529,2385,1050840730,026074,I124
6242,SAN POLO MATESE,CB,476,248,228,3140190710,070071,I122
6243,SAN PONSO,TO,248,127,121,1010812410,001251,I126
6244,SAN POSSIDONIO,MO,3451,1697,1754,1080500370,036038,I128
6245,SAN POTITO SANNITICO,CE,1961,965,996,3150200800,061080,I130
6246,SAN POTITO ULTRA,AV,1477,714,763,3150080850,064086,I129
6247,SAN PRISCO,CE,12114,5817,6297,3150200810,061081,I131
6248,SAN PROCOPIO,RC,495,245,250,3180670760,080076,I132
6249,SAN PROSPERO,MO,6020,3045,2975,1080500380,036039,I133
6250,SAN QUIRICO D'ORCIA,SI,2610,1276,1334,2090750300,052030,I135
6251,SAN QUIRINO,PN,4191,2087,2104,1060930400,093040,I136
6252,SAN RAFFAELE CIMENA,TO,3146,1549,1597,1010812420,001252,I137
6253,SAN ROBERTO,RC,1551,782,769,3180670770,080077,I139
6254,SAN ROCCO AL PORTO,LO,3347,1629,1718,1030990490,098049,I140
6255,SAN ROMANO IN GARFAGNANA,LU,1352,658,694,2090430270,046027,I142
6256,SAN RUFO,SA,1637,814,823,3150721260,065126,I143
6257,SAN SALVATORE DI FITALIA,ME,1150,518,632,4190480810,083082,I147
6258,SAN SALVATORE MONFERRATO,AL,4045,2008,2037,1010021510,006154,I144
6259,SAN SALVATORE TELESINO,BN,3842,1891,1951,3150110660,062068,I145
6260,SAN SALVO,CH,19555,9756,9799,3130230830,069083,I148
6261,SAN SEBASTIANO AL VESUVIO,,8721,4192,4529,3150510700,063070,I151
6262,SAN SEBASTIANO CURONE,AL,525,247,278,1010021520,006155,I150
6263,SAN SEBASTIANO DA PO,TO,1861,918,943,1010812430,001253,I152
6264,SAN SECONDO DI PINEROLO,TO,3597,1778,1819,1010812440,001254,I154
6265,SAN SECONDO PARMENSE,PR,5816,2890,2926,1080560330,034033,I153
6266,SAN SEVERINO LUCANO,PZ,1404,689,715,3170640770,076078,I157
6267,SAN SEVERINO MARCHE,MC,11985,5799,6186,2110440470,043047,I156
6268,SAN SEVERO,FG,49843,24360,25483,3160310490,071051,I158
6269,SAN SIRO,CO,1693,844,849,1030241955,013248,I162
6270,SAN SOSSIO BARONIA,AV,1523,737,786,3150080860,064087,I163
6271,SAN SOSTENE,CZ,1414,726,688,3180221130,079116,I164
6272,SAN SOSTI,CS,1879,939,940,3180251290,078128,I165
6273,SAN SPERATE,SU,8398,4196,4202,4201110650,111065,I166
6274,SAN STINO DI LIVENZA,VE,12720,6290,6430,1050870360,027036,I373
6275,SAN TAMMARO,CE,5714,2872,2842,3150200850,061085,I261
6276,SAN TEODORO,SS,4992,2514,2478,4200730615,090092,I329
6277,SAN TEODORO,SS,4992,2514,2478,4190480890,083090,I328
6278,SAN TEODORO,ME,1244,595,649,4200730615,090092,I329
6279,SAN TEODORO,ME,1244,595,649,4190480890,083090,I328
6280,SAN TOMASO AGORDINO,BL,608,307,301,1050100490,025049,I347
6281,SAN VALENTINO IN ABRUZZO CITERIORE,PE,1858,890,968,3130600380,068038,I376
6282,SAN VALENTINO TORIO,SA,10844,5409,5435,3150721320,065132,I377
6283,SAN VENANZO,TR,2182,1128,1054,2100800300,055030,I381
6284,SAN VENDEMIANO,TV,9884,4873,5011,1050840750,026076,I382
6285,SAN VERO MILIS,OR,2434,1216,1218,4200950500,095050,I384
6286,SAN VINCENZO,LI,6498,3067,3431,2090420180,049018,I390
6287,SAN VINCENZO LA COSTA,CS,2022,1001,1021,3180251350,078135,I388
6288,SAN VINCENZO VALLE ROVETO,AQ,2115,1031,1084,3130380910,066092,I389
6289,SAN VITALIANO,,6421,3138,3283,3150510750,063075,I391
6290,SAN VITO,SU,3488,1744,1744,4201110660,111066,I402
6291,SAN VITO AL TAGLIAMENTO,PN,15097,7383,7714,1060930410,093041,I403
6292,SAN VITO AL TORRE,UD,1202,592,610,1060851050,030105,I404
6293,SAN VITO CHIETINO,CH,5175,2563,2612,3130230860,069086,I394
6294,SAN VITO DEI NORMANNI,BR,18267,8818,9449,3160160170,074017,I396
6295,SAN VITO DI CADORE,BL,1935,942,993,1050100510,025051,I392
6296,SAN VITO DI FAGAGNA,UD,1679,828,851,1060851060,030106,I405
6297,SAN VITO DI LEGUZZANO,VI,3571,1731,1840,1050900960,024096,I401
6298,SAN VITO LO CAPO,TP,4820,2399,2421,4190820201,081020,I407
6299,SAN VITO ROMANO,RM,3075,1564,1511,2120700990,058100,I400
6300,SAN VITO SULLO IONIO,CZ,1629,776,853,3180221190,079122,I393
6301,SAN VITTORE DEL LAZIO,FR,2474,1247,1227,2120330690,060070,I408
6302,SAN VITTORE OLONA,MI,8259,3991,4268,1030492000,015201,I409
6303,SAN ZENO DI MONTAGNA,VR,1440,734,706,1050890780,023079,I414
6304,SAN ZENO NAVIGLIO,BS,4704,2329,2375,1030151640,017173,I412
6305,SAN ZENONE AL LAMBRO,MI,4489,2280,2209,1030492010,015202,I415
6306,SAN ZENONE AL PO,PV,540,267,273,1030571420,018145,I416
6307,SAN ZENONE DEGLI EZZELINI,TV,7282,3744,3538,1050840760,026077,I417
6308,SANARICA,LE,1469,712,757,3160410660,075067,H757
6309,SANDIGLIANO,BI,2570,1224,1346,1010960590,096059,H821
6310,SANDRIGO,VI,8221,4065,4156,1050900910,024091,H829
6311,SANFRE',CN,3050,1497,1553,1010272080,004208,H851
6312,SANFRONT,CN,2289,1136,1153,1010272090,004209,H852
6313,SANGANO,TO,3686,1749,1937,1010812311,001241,H855
6314,SANGIANO,VA,1459,752,707,1030861001,012141,H872
6315,SANGINETO,CS,1244,630,614,3180251180,078117,H877
6316,SANGUINETTO,VR,4069,2042,2027,1050890710,023072,H944
6317,SANLURI,SU,8170,4009,4161,4201110670,111067,H974
6318,SANNAZZARO DE' BURGONDI,PV,5098,2518,2580,1030571350,018138,I048
6319,SANNICANDRO DI BARI,BA,9592,4920,4672,3160090390,072040,I053
6320,SANNICOLA,LE,5702,2746,2956,3160410690,075070,I059
6321,SANREMO,IM,52918,25270,27648,1070370520,008055,I138
6322,SANSEPOLCRO,AR,15227,7425,7802,2090050340,051034,I155
6323,SANT'AGAPITO,IS,1411,717,694,3140940440,094044,I189
6324,SANT'AGATA BOLOGNESE,BO,7335,3675,3660,1080130560,037056,I191
6325,SANT'AGATA DE' GOTI,BN,10388,5132,5256,3150110680,062070,I197
6326,SANT'AGATA DEL BIANCO,RC,591,293,298,3180670790,080079,I198
6327,SANT'AGATA DI ESARO,CS,1715,872,843,3180251320,078131,I192
6328,SANT'AGATA DI MILITELLO,ME,11950,5633,6317,4190480830,083084,I199
6329,SANT'AGATA DI PUGLIA,FG,1831,905,926,3160310500,071052,I193
6330,SANT'AGATA FELTRIA,RN,1998,999,999,1081010176,099026,I201
6331,SANT'AGATA FOSSILI,AL,367,175,192,1010021530,006156,I190
6332,SANT'AGATA LI BATTIATI,CT,9338,4333,5005,4190210440,087045,I202
6333,SANT'AGATA SUL SANTERNO,RA,2869,1404,1465,1080660170,039017,I196
6334,SANT'AGNELLO,,8729,4225,4504,3150510710,063071,I208
6335,SANT'ALBANO STURA,CN,2357,1219,1138,1010272110,004211,I210
6336,SANT'ALESSIO CON VIALONE,PV,1017,525,492,1030571380,018141,I213
6337,SANT'ALESSIO IN ASPROMONTE,RC,331,164,167,3180670800,080080,I214
6338,SANT'ALESSIO SICULO,ME,1527,747,780,4190480840,083085,I215
6339,SANT'ALFIO,CT,1518,733,785,4190210450,087046,I216
6340,SANT'AMBROGIO DI TORINO,TO,4597,2290,2307,1010812450,001255,I258
6341,SANT'AMBROGIO DI VALPOLICELLA,VR,11923,5876,6047,1050890760,023077,I259
6342,SANT'AMBROGIO SUL GARIGLIANO,FR,879,454,425,2120330640,060065,I256
6343,SANT'ANASTASIA,,26460,12908,13552,3150510720,063072,I262
6344,SANT'ANATOLIA DI NARCO,PG,526,280,246,2100580450,054045,I263
6345,SANT'ANDREA APOSTOLO DELLO IONIO,CZ,1759,891,868,3180221150,079118,I266
6346,SANT'ANDREA DEL GARIGLIANO,FR,1311,654,657,2120330650,060066,I265
6347,SANT'ANDREA DI CONZA,AV,1368,666,702,3150080880,064089,I264
6348,SANT'ANDREA FRIUS,SU,1717,884,833,4201110690,111069,I271
6349,SANT'ANGELO A CUPOLO,BN,4117,2037,2080,3150110690,062071,I277
6350,SANT'ANGELO A FASANELLA,SA,514,245,269,3150721280,065128,I278
6351,SANT'ANGELO A SCALA,AV,702,387,315,3150080900,064091,I280
6352,SANT'ANGELO ALL'ESCA,AV,747,372,375,3150080890,064090,I279
6353,SANT'ANGELO D'ALIFE,CE,2089,1012,1077,3150200860,061086,I273
6354,SANT'ANGELO DEI LOMBARDI,AV,3913,1999,1914,3150080910,064092,I281
6355,SANT'ANGELO DEL PESCO,IS,325,163,162,3140940460,094046,I282
6356,SANT'ANGELO DI BROLO,ME,2806,1362,1444,4190480870,083088,I283
6357,SANT'ANGELO DI PIOVE DI SACCO,PD,7289,3615,3674,1050540820,028082,I275
6358,SANT'ANGELO IN PONTANO,MC,1244,584,660,2110440480,043048,I286
6359,SANT'ANGELO IN VADO,PU,3907,1947,1960,2110590570,041057,I287
6360,SANT'ANGELO LE FRATTE,PZ,1314,658,656,3170640780,076079,I288
6361,SANT'ANGELO LIMOSANO,CB,317,156,161,3140190730,070073,I289
6362,SANT'ANGELO LODIGIANO,LO,13346,6648,6698,1030990500,098050,I274
6363,SANT'ANGELO LOMELLINA,PV,817,420,397,1030571410,018144,I276
6364,SANT'ANGELO MUXARO,AG,1182,565,617,4190010380,084039,I290
6365,SANT'ANGELO ROMANO,RM,4945,2493,2452,2120700970,058098,I284
6366,SANT'ANNA ARRESI,SU,2663,1356,1307,4201110700,111070,M209
6367,SANT'ANNA D'ALFAEDO,VR,2540,1336,1204,1050890770,023078,I292
6368,SANT'ANTIMO,,32576,16006,16570,3150510730,063073,I293
6369,SANT'ANTIOCO,SU,10756,5309,5447,4201110710,111071,I294
6370,SANT'ANTONINO DI SUSA,TO,4064,1950,2114,1010812460,001256,I296
6371,SANT'ANTONIO ABATE,,19169,9518,9651,3150510740,063074,I300
6372,SANT'ANTONIO DI GALLURA,SS,1443,715,728,4200730602,090085,M276
6373,SANT'APOLLINARE,FR,1842,900,942,2120330660,060067,I302
6374,SANT'ARCANGELO,PZ,6032,2972,3060,3170640790,076080,I305
6375,SANT'ARCANGELO TRIMONTE,BN,480,246,234,3150110691,062078,F557
6376,SANT'ARPINO,CE,14910,7449,7461,3150200870,061087,I306
6377,SANT'ARSENIO,SA,2685,1284,1401,3150721290,065129,I307
6378,SANT'EGIDIO ALLA VIBRATA,TE,9804,4843,4961,3130790370,067038,I318
6379,SANT'EGIDIO DEL MONTE ALBINO,SA,8857,4362,4495,3150721300,065130,I317
6380,SANT'ELENA,PD,2530,1247,1283,1050540830,028083,I319
6381,SANT'ELENA SANNITA,IS,270,141,129,3140940470,094047,B466
6382,SANT'ELIA A PIANISI,CB,1585,765,820,3140190740,070074,I320
6383,SANT'ELIA FIUMERAPIDO,FR,5732,2846,2886,2120330670,060068,I321
6384,SANT'ELPIDIO A MARE,FM,16543,8224,8319,2111050370,109037,I324
6385,SANT'EUFEMIA A MAIELLA,PE,265,139,126,3130600370,068037,I332
6386,SANT'EUFEMIA D'ASPROMONTE,RC,3740,1830,1910,3180670810,080081,I333
6387,SANT'EUSANIO DEL SANGRO,CH,2279,1118,1161,3130230850,069085,I335
6388,SANT'EUSANIO FORCONESE,AQ,359,175,184,3130380891,066090,I336
6389,SANT'ILARIO D'ENZA,RE,11205,5547,5658,1080680390,035039,I342
6390,SANT'ILARIO DELLO IONIO,RC,1348,669,679,3180670820,080082,I341
6391,SANT'IPPOLITO,PU,1459,727,732,2110590580,041058,I344
6392,SANT'OLCESE,GE,5601,2792,2809,1070340550,010055,I346
6393,SANT'OMERO,TE,5112,2465,2647,3130790380,067039,I348
6394,SANT'OMOBONO TERME,BG,3862,1942,1920,1030121831,016252,M333
6395,SANT'ONOFRIO,VV,2872,1426,1446,3181030360,102036,I350
6396,SANT'ORESTE,RM,3504,1755,1749,2120700980,058099,I352
6397,SANT'ORSOLA TERME,TN,1106,567,539,1040831570,022168,I354
6398,SANT'URBANO,PD,1903,947,956,1050540840,028084,I375
6399,SANTA BRIGIDA,BG,523,261,262,1030121820,016191,I168
6400,SANTA CATERINA ALBANESE,CS,1128,548,580,3180251300,078129,I171
6401,SANTA CATERINA D'ESTE,PD,2389,1206,1183,1050540795,028108,M438
6402,SANTA CATERINA DELLO IONIO,CZ,1940,958,982,3180221140,079117,I170
6403,SANTA CATERINA VILLARMOSA,CL,4785,2240,2545,4190180170,085017,I169
6404,SANTA CESAREA TERME,LE,2847,1334,1513,3160410710,075072,I172
6405,SANTA CRISTINA D'ASPROMONTE,RC,774,387,387,3180670780,080078,I176
6406,SANTA CRISTINA E BISSONE,PV,1873,957,916,1030571360,018139,I175
6407,SANTA CRISTINA GELA,PA,990,504,486,4190550640,082066,I174
6408,SANTA CRISTINA VALGARDENA/ST. CHRISTINA IN GRODEN,BZ,2001,995,1006,1040140780,021085,I173
6409,SANTA CROCE CAMERINA,RG,10912,5812,5100,4190650100,088010,I178
6410,SANTA CROCE DEL SANNIO,BN,858,428,430,3150110670,062069,I179
6411,SANTA CROCE DI MAGLIANO,CB,4012,1947,2065,3140190720,070072,I181
6412,SANTA CROCE SULL'ARNO,PI,14608,7369,7239,2090620320,050033,I177
6413,SANTA DOMENICA TALAO,CS,1140,582,558,3180251310,078130,I183
6414,SANTA DOMENICA VITTORIA,ME,873,431,442,4190480820,083083,I184
6415,SANTA ELISABETTA,AG,2172,1053,1119,4190010361,084037,I185
6416,SANTA FIORA,GR,2485,1224,1261,2090360210,053022,I187
6417,SANTA FLAVIA,PA,10999,5380,5619,4190550650,082067,I188
6418,SANTA GIULETTA,PV,1563,762,801,1030571370,018140,I203
6419,SANTA GIUSTA,OR,4646,2321,2325,4200950470,095047,I205
6420,SANTA GIUSTINA,BL,6634,3222,3412,1050100480,025048,I206
6421,SANTA GIUSTINA IN COLLE,PD,7156,3596,3560,1050540800,028080,I207
6422,SANTA LUCE,PI,1637,797,840,2090620330,050034,I217
6423,SANTA LUCIA DEL MELA,ME,4428,2184,2244,4190480850,083086,I220
6424,SANTA LUCIA DI PIAVE,TV,9127,4586,4541,1050840740,026075,I221
6425,SANTA LUCIA DI SERINO,AV,1405,692,713,3150080870,064088,I219
6426,SANTA MARGHERITA DI BELICE,AG,6097,2959,3138,4190010370,084038,I224
6427,SANTA MARGHERITA DI STAFFORA,PV,448,238,210,1030571390,018142,I230
6428,SANTA MARGHERITA LIGURE,GE,8575,3981,4594,1070340540,010054,I225
6429,SANTA MARIA A MONTE,PI,13307,6567,6740,2090620340,050035,I232
6430,SANTA MARIA A VICO,CE,14249,6958,7291,3150200820,061082,I233
6431,SANTA MARIA CAPUA VETERE,CE,31934,15187,16747,3150200830,061083,I234
6432,SANTA MARIA COGHINAS,SS,1309,671,638,4200730603,090087,M284
6433,SANTA MARIA DEL CEDRO,CS,4949,2443,2506,3180251321,078132,C717
6434,SANTA MARIA DEL MOLISE,IS,664,343,321,3140940450,094045,I238
6435,SANTA MARIA DELLA VERSA,PV,2242,1091,1151,1030571400,018143,I237
6436,SANTA MARIA DI LICODIA,CT,7453,3654,3799,4190210460,087047,I240
6437,SANTA MARIA DI SALA,VE,17449,8716,8733,1050870350,027035,I242
6438,SANTA MARIA HOE',LC,2130,1087,1043,1030980740,097074,I243
6439,SANTA MARIA IMBARO,CH,2020,1020,1000,3130230840,069084,I244
6440,SANTA MARIA LA CARITA',,11689,5824,5865,3150510711,063090,M273
6441,SANTA MARIA LA FOSSA,CE,2559,1270,1289,3150200840,061084,I247
6442,SANTA MARIA LA LONGA,UD,2313,1139,1174,1060851040,030104,I248
6443,SANTA MARIA MAGGIORE,VB,1290,622,668,1011020620,103062,I249
6444,SANTA MARIA NUOVA,AN,3980,1964,2016,2110030430,042043,I251
6445,SANTA MARINA,SA,3198,1576,1622,3150721270,065127,I253
6446,SANTA MARINA SALINA,ME,854,452,402,4190480860,083087,I254
6447,SANTA MARINELLA,RM,18531,9012,9519,2120700960,058097,I255
6448,SANTA NINFA,TP,4838,2333,2505,4190820200,081019,I291
6449,SANTA PAOLINA,AV,1175,573,602,3150080920,064093,I301
6450,SANTA SEVERINA,KR,1929,952,977,3180970220,101022,I308
6451,SANTA SOFIA,FC,4018,1944,2074,1080320420,040043,I310
6452,SANTA SOFIA D'EPIRO,CS,2205,1066,1139,3180251330,078133,I309
6453,SANTA TERESA DI RIVA,ME,9337,4444,4893,4190480880,083089,I311
6454,SANTA TERESA GALLURA,SS,5006,2525,2481,4200730610,090063,I312
6455,SANTA VENERINA,CT,8421,4133,4288,4190210470,087048,I314
6456,SANTA VITTORIA D'ALBA,CN,2874,1451,1423,1010272120,004212,I316
6457,SANTA VITTORIA IN MATENANO,FM,1227,596,631,2111050360,109036,I315
6458,SANTADI,SU,3194,1572,1622,4201110680,111068,I182
6459,SANTARCANGELO DI ROMAGNA,RN,22184,10785,11399,1081010180,099018,I304
6460,SANTE MARIE,AQ,1099,556,543,3130380890,066089,I326
6461,SANTENA,TO,10531,5203,5328,1010812470,001257,I327
6462,SANTERAMO IN COLLE,BA,25870,12745,13125,3160090400,072041,I330
6463,SANTHIA',VC,8109,3912,4197,1010881320,002133,I337
6464,SANTI COSMA E DAMIANO,LT,6854,3389,3465,2120400260,059026,I339
6465,SANTO STEFANO AL MARE,IM,2031,1003,1028,1070370521,008056,I365
6466,SANTO STEFANO BELBO,CN,3823,1902,1921,1010272130,004213,I367
6467,SANTO STEFANO D'AVETO,GE,991,512,479,1070340560,010056,I368
6468,SANTO STEFANO DEL SOLE,AV,2076,1014,1062,3150080940,064095,I357
6469,SANTO STEFANO DI CADORE,BL,2405,1169,1236,1050100500,025050,C919
6470,SANTO STEFANO DI CAMASTRA,ME,4415,2113,2302,4190480900,083091,I370
6471,SANTO STEFANO DI MAGRA,SP,9837,4860,4977,1070390260,011026,I363
6472,SANTO STEFANO DI ROGLIANO,CS,1704,837,867,3180251340,078134,I359
6473,SANTO STEFANO DI SESSANIO,AQ,115,54,61,3130380900,066091,I360
6474,SANTO STEFANO IN ASPROMONTE,RC,1091,568,523,3180670830,080083,I371
6475,SANTO STEFANO LODIGIANO,LO,1849,927,922,1030990510,098051,I362
6476,SANTO STEFANO QUISQUINA,AG,4159,2006,2153,4190010390,084040,I356
6477,SANTO STEFANO ROERO,CN,1325,632,693,1010272140,004214,I372
6478,SANTO STEFANO TICINO,MI,4932,2428,2504,1030491990,015200,I361
6479,SANTOMENNA,SA,401,209,192,3150721310,065131,I260
6480,SANTOPADRE,FR,1215,613,602,2120330680,060069,I351
6481,SANTORSO,VI,5530,2743,2787,1050900950,024095,I353
6482,SANTU LUSSURGIU,OR,2229,1110,1119,4200950490,095049,I374
6483,SANZA,SA,2372,1212,1160,3150721330,065133,I410
6484,SANZENO,TN,919,456,463,1040831580,022169,I411
6485,SAONARA,PD,10476,5194,5282,1050540850,028085,I418
6486,SAPONARA,ME,3704,1819,1885,4190480901,083092,I420
6487,SAPPADA,UD,1308,645,663,1060851065,030189,I421
6488,SAPRI,SA,6401,3045,3356,3150721340,065134,I422
6489,SARACENA,CS,3451,1687,1764,3180251360,078136,I423
6490,SARACINESCO,RM,166,95,71,2120701000,058101,I424
6491,SARCEDO,VI,5337,2660,2677,1050900970,024097,I425
6492,SARCONI,PZ,1406,713,693,3170640800,076081,I426
6493,SARDARA,SU,3842,1897,1945,4201110720,111072,I428
6494,SARDIGLIANO,AL,386,186,200,1010021540,006157,I429
6495,SAREGO,VI,6709,3417,3292,1050900980,024098,I430
6496,SARENTINO/SARNTAL,BZ,7190,3638,3552,1040140790,021086,I431
6497,SAREZZANO,AL,1124,564,560,1010021550,006158,I432
6498,SAREZZO,BS,13132,6519,6613,1030151650,017174,I433
6499,SARMATO,PC,2950,1494,1456,1080610420,033042,I434
6500,SARMEDE,TV,2951,1483,1468,1050840770,026078,I435
6501,SARNANO,MC,3069,1489,1580,2110440490,043049,I436
6502,SARNICO,BG,6731,3264,3467,1030121840,016193,I437
6503,SARNO,SA,30652,15190,15462,3150721350,065135,I438
6504,SARNONICO,TN,795,403,392,1040831590,022170,I439
6505,SARONNO,VA,38582,18396,20186,1030861010,012119,I441
6506,SARRE,AO,4755,2302,2453,1020040650,007066,I442
6507,SARROCH,CA,5057,2541,2516,4200170660,092066,I443
6508,SARSINA,FC,3303,1648,1655,1080320430,040044,I444
6509,SARTEANO,SI,4476,2112,2364,2090750310,052031,I445
6510,SARTIRANA LOMELLINA,PV,1457,701,756,1030571430,018146,I447
6511,SARULE,NU,1564,763,801,4200530740,091077,I448
6512,SARZANA,SP,21610,10438,11172,1070390270,011027,I449
6513,SASSANO,SA,4634,2247,2387,3150721360,065136,I451
6514,SASSARI,SS,122159,58742,63417,4200730620,090064,I452
6515,SASSELLO,SV,1747,909,838,1070740550,009055,I453
6516,SASSETTA,LI,475,230,245,2090420190,049019,I454
6517,SASSINORO,BN,633,306,327,3150110700,062072,I455
6518,SASSO DI CASTALDA,PZ,751,390,361,3170640810,076082,I457
6519,SASSO MARCONI,BO,14798,7154,7644,1080130570,037057,G972
6520,SASSOCORVARO AUDITORE,PU,4870,2440,2430,2110590595,041071,M413
6521,SASSOFELTRIO,RN,1366,653,713,1081010183,099031,I460
6522,SASSOFERRATO,AN,6875,3351,3524,2110030440,042044,I461
6523,SASSUOLO,MO,40469,19931,20538,1080500390,036040,I462
6524,SATRIANO,CZ,3360,1620,1740,3180221200,079123,I463
6525,SATRIANO DI LUCANIA,PZ,2249,1124,1125,3170640820,076083,G614
6526,SAURIS,UD,390,190,200,1060851070,030107,I464
6527,SAUZE D'OULX,TO,1043,552,491,1010812490,001259,I466
6528,SAUZE DI CESANA,TO,251,139,112,1010812480,001258,I465
6529,SAVA,TA,15423,7458,7965,3160780260,073026,I467
6530,SAVELLI,KR,1045,526,519,3180970230,101023,I468
6531,SAVIANO,,15933,7816,8117,3150510760,063076,I469
6532,SAVIGLIANO,CN,21453,10467,10986,1010272150,004215,I470
6533,SAVIGNANO IRPINO,AV,1026,521,505,3150080950,064096,I471
6534,SAVIGNANO SUL PANARO,MO,9415,4642,4773,1080500400,036041,I473
6535,SAVIGNANO SUL RUBICONE,FC,17797,8830,8967,1080320440,040045,I472
6536,SAVIGNONE,GE,3038,1507,1531,1070340570,010057,I475
6537,SAVIORE DELL'ADAMELLO,BS,802,386,416,1030151651,017175,I476
6538,SAVOCA,ME,1697,822,875,4190480910,083093,I477
6539,SAVOGNA,UD,351,183,168,1060851080,030108,I478
6540,SAVOGNA D'ISONZO,GO,1694,872,822,1060350180,031022,I479
6541,SAVOIA DI LUCANIA,PZ,1020,508,512,3170640830,076084,H730
6542,SAVONA,SV,58534,27562,30972,1070740560,009056,I480
6543,SCAFA,PE,3508,1694,1814,3130600390,068039,I482
6544,SCAFATI,SA,48421,23639,24782,3150721370,065137,I483
6545,SCAGNELLO,CN,174,83,91,1010272160,004216,I484
6546,SCALA,SA,1504,766,738,3150721380,065138,I486
6547,SCALA COELI,CS,828,390,438,3180251370,078137,I485
6548,SCALDASOLE,PV,852,425,427,1030571440,018147,I487
6549,SCALEA,CS,11076,5584,5492,3180251380,078138,I489
6550,SCALENGHE,TO,3244,1649,1595,1010812500,001260,I490
6551,SCALETTA ZANCLEA,ME,1871,894,977,4190480920,083094,I492
6552,SCAMPITELLA,AV,1049,501,548,3150080960,064097,I493
6553,SCANDALE,KR,2889,1416,1473,3180970240,101024,I494
6554,SCANDIANO,RE,25767,12520,13247,1080680400,035040,I496
6555,SCANDICCI,FI,49659,23748,25911,2090300410,048041,B962
6556,SCANDOLARA RAVARA,CR,1297,648,649,1030260890,019092,I497
6557,SCANDOLARA RIPA D'OGLIO,CR,532,277,255,1030260900,019093,I498
6558,SCANDRIGLIA,RI,3232,1728,1504,2120690620,057064,I499
6559,SCANNO,AQ,1723,839,884,3130380920,066093,I501
6560,SCANO DI MONTIFERRO,OR,1417,694,723,4200950510,095051,I503
6561,SCANSANO,GR,4263,2204,2059,2090360220,053023,I504
6562,SCANZANO JONICO,MT,7525,3769,3756,3170470251,077031,M256
6563,SCANZOROSCIATE,BG,9881,4843,5038,1030121850,016194,I506
6564,SCAPOLI,IS,591,291,300,3140940480,094048,I507
6565,SCARLINO,GR,3814,1927,1887,2090360221,053024,I510
6566,SCARMAGNO,TO,802,385,417,1010812510,001261,I511
6567,SCARNAFIGI,CN,2149,1105,1044,1010272170,004217,I512
6568,SCARPERIA E SAN PIERO,FI,12018,5929,6089,2090300421,048053,M326
6569,SCENA/SCHENNA,BZ,2980,1495,1485,1040140800,021087,I519
6570,SCERNI,CH,3020,1479,1541,3130230870,069087,I520
6571,SCHEGGIA E PASCELUPO,PG,1280,641,639,2100580460,054046,I522
6572,SCHEGGINO,PG,451,221,230,2100580470,054047,I523
6573,SCHIAVI DI ABRUZZO,CH,679,320,359,3130230880,069088,I526
6574,SCHIAVON,VI,2603,1332,1271,1050900990,024099,I527
6575,SCHIGNANO,CO,884,467,417,1030241980,013211,I529
6576,SCHILPARIO,BG,1140,562,578,1030121860,016195,I530
6577,SCHIO,VI,38533,18893,19640,1050901000,024100,I531
6578,SCHIVENOGLIA,MN,1090,547,543,1030450600,020060,I532
6579,SCIACCA,AG,39263,19092,20171,4190010400,084041,I533
6580,SCIARA,PA,2569,1274,1295,4190550660,082068,I534
6581,SCICLI,RG,26878,13221,13657,4190650110,088011,I535
6582,SCIDO,RC,841,405,436,3180670840,080084,I536
6583,SCIGLIANO,CS,1116,537,579,3180251390,078139,D290
6584,SCILLA,RC,4576,2222,2354,3180670850,080085,I537
6585,SCILLATO,PA,614,286,328,4190550661,082081,I538
6586,SCIOLZE,TO,1463,732,731,1010812520,001262,I539
6587,SCISCIANO,,6150,3019,3131,3150510770,063077,I540
6588,SCLAFANI BAGNI,PA,387,182,205,4190550670,082069,I541
6589,SCONTRONE,AQ,555,308,247,3130380930,066094,I543
6590,SCOPA,VC,373,186,187,1010881330,002134,I544
6591,SCOPELLO,VC,372,195,177,1010881340,002135,I545
6592,SCOPPITO,AQ,3762,1887,1875,3130380940,066095,I546
6593,SCORDIA,CT,16211,8106,8105,4190210480,087049,I548
6594,SCORRANO,LE,6726,3281,3445,3160410720,075073,I549
6595,SCORZE',VE,18965,9483,9482,1050870370,027037,I551
6596,SCURCOLA MARSICANA,AQ,2698,1340,1358,3130380950,066096,I553
6597,SCURELLE,TN,1334,667,667,1040831600,022171,I554
6598,SCURZOLENGO,AT,516,258,258,1010071030,005103,I555
6599,SEBORGA,IM,281,137,144,1070370530,008057,I556
6600,SECINARO,AQ,321,170,151,3130380960,066097,I558
6601,SECLI',LE,1820,873,947,3160410730,075074,I559
6602,SECUGNAGO,LO,1945,960,985,1030990520,098052,I561
6603,SEDEGLIANO,UD,3704,1854,1850,1060851090,030109,I562
6604,SEDICO,BL,10161,4984,5177,1050100530,025053,I563
6605,SEDILO,OR,1995,994,1001,4200950520,095052,I564
6606,SEDINI,SS,1256,592,664,4200730630,090065,I565
6607,SEDRIANO,MI,12551,6266,6285,1030492030,015204,I566
6608,SEDRINA,BG,2438,1263,1175,1030121870,016196,I567
6609,SEFRO,MC,418,213,205,2110440500,043050,I569
6610,SEGARIU,SU,1112,553,559,4201110730,111073,I570
6611,SEGGIANO,GR,983,498,485,2090360230,053025,I571
6612,SEGNI,RM,8983,4425,4558,2120701010,058102,I573
6613,SEGONZANO,TN,1388,683,705,1040831610,022172,I576
6614,SEGRATE,MI,36591,17676,18915,1030492040,015205,I577
6615,SEGUSINO,TV,1823,919,904,1050840780,026079,I578
6616,SELARGIUS,CA,28648,13818,14830,4200170680,092068,I580
6617,SELCI,RI,1112,557,555,2120690630,057065,I581
6618,SELEGAS,SU,1306,642,664,4201110740,111074,I582
6619,SELLA GIUDICARIE,TN,2892,1452,1440,1040831615,022246,M360
6620,SELLANO,PG,1002,499,503,2100580480,054048,I585
6621,SELLERO,BS,1400,702,698,1030151660,017176,I588
6622,SELLIA,CZ,494,230,264,3180221230,079126,I589
6623,SELLIA MARINA,CZ,7579,3839,3740,3180221231,079127,I590
6624,SELVA DEI MOLINI/MUHLWALD,BZ,1399,733,666,1040140820,021088,I593
6625,SELVA DI CADORE,BL,493,243,250,1050100540,025054,I592
6626,SELVA DI PROGNO,VR,884,465,419,1050890790,023080,I594
6627,SELVA DI VAL GARDENA/WOLKENSTEIN IN GRODEN,BZ,2592,1284,1308,1040140821,021089,I591
6628,SELVAZZANO DENTRO,PD,22961,11100,11861,1050540860,028086,I595
6629,SELVINO,BG,2000,1021,979,1030121880,016197,I597
6630,SEMESTENE,SS,141,68,73,4200730640,090066,I598
6631,SEMIANA,PV,197,102,95,1030571450,018148,I599
6632,SEMINARA,RC,2488,1220,1268,3180670860,080086,I600
6633,SEMPRONIANO,GR,984,469,515,2090360231,053028,I601
6634,SENAGO,MI,21360,10526,10834,1030492050,015206,I602
6635,SENALE-SAN FELICE/UNSERE LIEBE FRAU IM WALDE-ST. FELIX,BZ,781,402,379,1040140841,021118,I603
6636,SENALES/SCHNALS,BZ,1261,648,613,1040140840,021091,I604
6637,SENEGHE,OR,1682,840,842,4200950530,095053,I605
6638,SENERCHIA,AV,751,406,345,3150080970,064098,I606
6639,SENIGA,BS,1427,724,703,1030151670,017177,I607
6640,SENIGALLIA,AN,44245,21249,22996,2110030450,042045,I608
6641,SENIS,OR,424,195,229,4200950540,095054,I609
6642,SENISE,PZ,6635,3318,3317,3170640840,076085,I610
6643,SENNA COMASCO,CO,3161,1601,1560,1030241990,013212,I611
6644,SENNA LODIGIANA,LO,1764,873,891,1030990530,098053,I612
6645,SENNARIOLO,OR,155,72,83,4200950550,095055,I613
6646,SENNORI,SS,6935,3451,3484,4200730650,090067,I614
6647,SENORBI',SU,4762,2369,2393,4201110750,111075,I615
6648,SEPINO,CB,1795,943,852,3140190750,070075,I618
6649,SEQUALS,PN,2170,1082,1088,1060930420,093042,I621
6650,SERAVEZZA,LU,12441,5942,6499,2090430280,046028,I622
6651,SERDIANA,SU,2665,1341,1324,4201110760,111076,I624
6652,SEREGNO,MB,44825,21662,23163,1031040390,108039,I625
6653,SEREN DEL GRAPPA,BL,2375,1208,1167,1050100550,025055,I626
6654,SERGNANO,CR,3505,1767,1738,1030260910,019094,I627
6655,SERIATE,BG,25169,12377,12792,1030121890,016198,I628
6656,SERINA,BG,2051,1062,989,1030121900,016199,I629
6657,SERINO,AV,6769,3389,3380,3150080980,064099,I630
6658,SERLE,BS,3060,1513,1547,1030151680,017178,I631
6659,SERMIDE E FELONICA,MN,7112,3576,3536,1030450610,020061,I632
6660,SERMONETA,LT,10044,5053,4991,2120400270,059027,I634
6661,SERNAGLIA DELLA BATTAGLIA,TV,6086,3039,3047,1050840790,026080,I635
6662,SERNIO,SO,475,241,234,1030770590,014059,I636
6663,SEROLE,AT,102,50,52,1010071040,005104,I637
6664,SERRA D'AIELLO,CS,514,258,256,3180251400,078140,I642
6665,SERRA DE' CONTI,AN,3558,1764,1794,2110030460,042046,I643
6666,SERRA RICCO',GE,7615,3776,3839,1070340580,010058,I640
6667,SERRA SAN BRUNO,VV,6355,3198,3157,3181030370,102037,I639
6668,SERRA SAN QUIRICO,AN,2552,1208,1344,2110030470,042047,I653
6669,SERRA SANT'ABBONDIO,PU,919,461,458,2110590610,041061,I654
6670,SERRACAPRIOLA,FG,3704,1818,1886,3160310510,071053,I641
6671,SERRADIFALCO,CL,5588,2652,2936,4190180180,085018,I644
6672,SERRALUNGA D'ALBA,CN,554,286,268,1010272180,004218,I646
6673,SERRALUNGA DI CREA,AL,509,259,250,1010021560,006159,I645
6674,SERRAMANNA,SU,8640,4275,4365,4201110770,111077,I647
6675,SERRAMAZZONI,MO,8516,4343,4173,1080500410,036042,F357
6676,SERRAMEZZANA,SA,290,140,150,3150721390,065139,I648
6677,SERRAMONACESCA,PE,531,280,251,3130600400,068040,I649
6678,SERRAPETRONA,MC,896,434,462,2110440510,043051,I651
6679,SERRARA FONTANA,,3044,1511,1533,3150510780,063078,I652
6680,SERRASTRETTA,CZ,2945,1471,1474,3180221250,079129,I655
6681,SERRATA,RC,796,395,401,3180670870,080087,I656
6682,SERRAVALLE A PO,MN,1441,705,736,1030450620,020062,I662
6683,SERRAVALLE DI CHIENTI,MC,1055,549,506,2110440520,043052,I661
6684,SERRAVALLE LANGHE,CN,300,157,143,1010272190,004219,I659
6685,SERRAVALLE PISTOIESE,PT,11742,5767,5975,2090630190,047020,I660
6686,SERRAVALLE SCRIVIA,AL,5878,2922,2956,1010021570,006160,I657
6687,SERRAVALLE SESIA,VC,4751,2304,2447,1010881360,002137,I663
6688,SERRE,SA,3701,1869,1832,3150721400,065140,I666
6689,SERRENTI,SU,4581,2328,2253,4201110780,111078,I667
6690,SERRI,SU,629,311,318,4201110790,111079,I668
6691,SERRONE,FR,3016,1534,1482,2120330700,060071,I669
6692,SERSALE,CZ,4291,2092,2199,3180221260,079130,I671
6693,SERVIGLIANO,FM,2179,1083,1096,2111050380,109038,C070
6694,SESSA AURUNCA,CE,20366,9955,10411,3150200880,061088,I676
6695,SESSA CILENTO,SA,1200,576,624,3150721410,065141,I677
6696,SESSAME,AT,239,116,123,1010071050,005105,I678
6697,SESSANO DEL MOLISE,IS,663,310,353,3140940490,094049,I679
6698,SESTA GODANO,SP,1273,652,621,1070390280,011028,E070
6699,SESTINO,AR,1218,605,613,2090050350,051035,I681
6700,SESTO AL REGHENA,PN,6301,3154,3147,1060930430,093043,I686
6701,SESTO CALENDE,VA,10969,5280,5689,1030861020,012120,I688
6702,SESTO CAMPANO,IS,2140,1031,1109,3140940500,094050,I682
6703,SESTO ED UNITI,CR,3185,1577,1608,1030260920,019095,I683
6704,SESTO FIORENTINO,FI,48782,23216,25566,2090300430,048043,I684
6705,SESTO SAN GIOVANNI,MI,79442,38270,41172,1030492080,015209,I690
6706,SESTO/SEXTEN,BZ,1846,914,932,1040140850,021092,I687
6707,SESTOLA,MO,2443,1212,1231,1080500420,036043,I689
6708,SESTRI LEVANTE,GE,17607,8372,9235,1070340590,010059,I693
6709,SESTRIERE,TO,919,478,441,1010812530,001263,I692
6710,SESTU,CA,20800,10476,10324,4200170740,092074,I695
6711,SETTALA,MI,7267,3642,3625,1030492090,015210,I696
6712,SETTEFRATI,FR,709,350,359,2120330710,060072,I697
6713,SETTEVILLE,BL,5781,2904,2877,1050100555,025075,M437
6714,SETTIME,AT,559,278,281,1010071060,005106,I698
6715,SETTIMO MILANESE,MI,20062,9731,10331,1030492100,015211,I700
6716,SETTIMO ROTTARO,TO,473,225,248,1010812540,001264,I701
6717,SETTIMO SAN PIETRO,CA,6882,3407,3475,4200170750,092075,I699
6718,SETTIMO TORINESE,TO,46056,22342,23714,1010812550,001265,I703
6719,SETTIMO VITTONE,TO,1491,768,723,1010812560,001266,I702
6720,SETTINGIANO,CZ,3204,1625,1579,3180221270,079131,I704
6721,SETZU,SU,133,69,64,4201110800,111080,I705
6722,SEUI,SU,1178,596,582,4201110810,111081,I706
6723,SEULO,SU,795,410,385,4201110820,111082,I707
6724,SEVESO,MB,23804,11715,12089,1031040400,108040,I709
6725,SEZZADIO,AL,1174,565,609,1010021580,006161,I711
6726,SEZZE,LT,23726,11948,11778,2120400280,059028,I712
6727,SFRUZ,TN,370,186,184,1040831620,022173,I714
6728,SGONICO,TS,1999,998,1001,1060920050,032005,I715
6729,SGURGOLA,FR,2389,1150,1239,2120330720,060073,I716
6730,SIAMAGGIORE,OR,884,448,436,4200950560,095056,I717
6731,SIAMANNA,OR,773,394,379,4200950570,095057,I718
6732,SIANO,SA,9496,4663,4833,3150721420,065142,I720
6733,SIAPICCIA,OR,344,172,172,4200950571,095076,I721
6734,SICIGNANO DEGLI ALBURNI,SA,3101,1528,1573,3150721430,065143,M253
6735,SICULIANA,AG,4176,2065,2111,4190010410,084042,I723
6736,SIDDI,SU,595,302,293,4201110830,111083,I724
6737,SIDERNO,RC,17610,8642,8968,3180670880,080088,I725
6738,SIENA,SI,53062,24748,28314,2090750320,052032,I726
6739,SIGILLO,PG,2305,1118,1187,2100580490,054049,I727
6740,SIGNA,FI,18964,9288,9676,2090300440,048044,I728
6741,SILANDRO/SCHLANDERS,BZ,6290,3124,3166,1040140860,021093,I729
6742,SILANUS,NU,2018,991,1027,4200530800,091083,I730
6743,SILEA,TV,10219,4955,5264,1050840800,026081,F116
6744,SILIGO,SS,812,402,410,4200730660,090068,I732
6745,SILIQUA,SU,3614,1795,1819,4201110840,111084,I734
6746,SILIUS,SU,1064,566,498,4201110850,111085,I735
6747,SILLANO GIUNCUGNANO,LU,999,490,509,2090430291,046037,M347
6748,SILLAVENGO,NO,556,286,270,1010521310,003138,I736
6749,SILVANO D'ORBA,AL,1914,961,953,1010021590,006162,I738
6750,SILVANO PIETRA,PV,632,316,316,1030571460,018149,I739
6751,SILVI,TE,15388,7533,7855,3130790390,067040,I741
6752,SIMALA,OR,284,148,136,4200950580,095058,I742
6753,SIMAXIS,OR,2146,1081,1065,4200950590,095059,I743
6754,SIMBARIO,VV,923,458,465,3181030380,102038,I744
6755,SIMERI CRICHI,CZ,4748,2332,2416,3180221290,079133,I745
6756,SINAGRA,ME,2498,1231,1267,4190480930,083095,I747
6757,SINALUNGA,SI,12128,5921,6207,2090750330,052033,A468
6758,SINDIA,NU,1609,773,836,4200530810,091084,I748
6759,SINI,OR,485,253,232,4200950600,095060,I749
6760,SINIO,CN,478,244,234,1010272200,004220,I750
6761,SINISCOLA,NU,11245,5667,5578,4200530820,091085,I751
6762,SINNAI,CA,17323,8617,8706,4200170800,092080,I752
6763,SINOPOLI,RC,1891,947,944,3180670890,080089,I753
6764,SIRACUSA,SR,117055,57349,59706,4190760170,089017,I754
6765,SIRIGNANO,AV,2831,1386,1445,3150080990,064100,I756
6766,SIRIS,OR,223,120,103,4200950610,095061,I757
6767,SIRMIONE,BS,8257,3954,4303,1030151690,017179,I633
6768,SIROLO,AN,4096,1963,2133,2110030480,042048,I758
6769,SIRONE,LC,2305,1129,1176,1030980750,097075,I759
6770,SIRTORI,LC,2777,1407,1370,1030980760,097076,I761
6771,SISSA TRECASALI,PR,7842,3863,3979,1080560345,034049,M325
6772,SIURGUS DONIGALA,SU,1848,915,933,4201110860,111086,I765
6773,SIZIANO,PV,6451,3205,3246,1030571470,018150,E265
6774,SIZZANO,NO,1360,663,697,1010521320,003139,I767
6775,SLUDERNO/SCHLUDERNS,BZ,1834,918,916,1040140870,021094,I771
6776,SMERILLO,FM,336,170,166,2111050390,109039,I774
6777,SOAVE,VR,7156,3525,3631,1050890800,023081,I775
6778,SOCCHIEVE,UD,860,426,434,1060851100,030110,I777
6779,SODDI',OR,120,54,66,4200950611,095078,I778
6780,SOGLIANO AL RUBICONE,FC,3147,1576,1571,1080320450,040046,I779
6781,SOGLIANO CAVOUR,LE,3932,1948,1984,3160410740,075075,I780
6782,SOGLIO,AT,135,67,68,1010071070,005107,I781
6783,SOIANO DEL LAGO,BS,1949,979,970,1030151700,017180,I782
6784,SOLAGNA,VI,1807,897,910,1050901010,024101,I783
6785,SOLARINO,SR,7578,3744,3834,4190760180,089018,I785
6786,SOLARO,MI,13924,6883,7041,1030492120,015213,I786
6787,SOLAROLO,RA,4393,2144,2249,1080660180,039018,I787
6788,SOLAROLO RAINERIO,CR,900,450,450,1030260930,019096,I790
6789,SOLARUSSA,OR,2291,1125,1166,4200950620,095062,I791
6790,SOLBIATE ARNO,VA,4021,1944,2077,1030861030,012121,I793
6791,SOLBIATE CON CAGNO,CO,4631,2265,2366,1030242025,013255,M412
6792,SOLBIATE OLONA,VA,5359,2663,2696,1030861040,012122,I794
6793,SOLDANO,IM,996,507,489,1070370540,008058,I796
6794,SOLEMINIS,SU,1854,926,928,4201110870,111087,I797
6795,SOLERO,AL,1565,772,793,1010021600,006163,I798
6796,SOLESINO,PD,6810,3351,3459,1050540870,028087,I799
6797,SOLETO,LE,5236,2505,2731,3160410750,075076,I800
6798,SOLFERINO,MN,2621,1297,1324,1030450630,020063,I801
6799,SOLIERA,MO,15425,7641,7784,1080500430,036044,I802
6800,SOLIGNANO,PR,1701,882,819,1080560350,034035,I803
6801,SOLOFRA,AV,12163,6019,6144,3150081000,064101,I805
6802,SOLONGHELLO,AL,195,102,93,1010021610,006164,I808
6803,SOLOPACA,BN,3517,1623,1894,3150110710,062073,I809
6804,SOLTO COLLINA,BG,1779,892,887,1030121910,016200,I812
6805,SOLZA,BG,1985,1009,976,1030121911,016251,I813
6806,SOMAGLIA,LO,3839,1906,1933,1030990540,098054,I815
6807,SOMANO,CN,310,160,150,1010272210,004221,I817
6808,SOMMA LOMBARDO,VA,17749,8706,9043,1030861050,012123,I819
6809,SOMMA VESUVIANA,,33935,16631,17304,3150510790,063079,I820
6810,SOMMACAMPAGNA,VR,14572,7296,7276,1050890810,023082,I821
6811,SOMMARIVA DEL BOSCO,CN,6271,3099,3172,1010272220,004222,I822
6812,SOMMARIVA PERNO,CN,2694,1303,1391,1010272230,004223,I823
6813,SOMMATINO,CL,6441,3029,3412,4190180190,085019,I824
6814,SOMMO,PV,1145,571,574,1030571480,018151,I825
6815,SONA,VR,17585,8734,8851,1050890820,023083,I826
6816,SONCINO,CR,7507,3717,3790,1030260940,019097,I827
6817,SONDALO,SO,3930,1913,2017,1030770600,014060,I828
6818,SONDRIO,SO,21192,9967,11225,1030770610,014061,I829
6819,SONGAVAZZO,BG,696,355,341,1030121920,016201,I830
6820,SONICO,BS,1211,613,598,1030151710,017181,I831
6821,SONNINO,LT,7440,3693,3747,2120400290,059029,I832
6822,SORA,FR,25059,12276,12783,2120330730,060074,I838
6823,SORAGA DI FASSA,TN,695,360,335,1040831650,022176,I839
6824,SORAGNA,PR,4778,2403,2375,1080560360,034036,I840
6825,SORANO,GR,3097,1523,1574,2090360240,053026,I841
6826,SORBO SAN BASILE,CZ,773,372,401,3180221300,079134,I844
6827,SORBO SERPICO,AV,534,271,263,3150081010,064102,I843
6828,SORBOLO MEZZANI,PR,12719,6312,6407,1080560375,034051,M411
6829,SORDEVOLO,BI,1299,637,662,1010960630,096063,I847
6830,SORDIO,LO,3387,1724,1663,1030990550,098055,I848
6831,SORESINA,CR,8744,4325,4419,1030260950,019098,I849
6832,SORGA',VR,2930,1500,1430,1050890830,023084,I850
6833,SORGONO,NU,1529,772,757,4200530830,091086,I851
6834,SORI,GE,4018,1954,2064,1070340600,010060,I852
6835,SORIANELLO,VV,1098,569,529,3181030390,102039,I853
6836,SORIANO CALABRO,VV,2306,1145,1161,3181030400,102040,I854
6837,SORIANO NEL CIMINO,VT,8021,3940,4081,2120910470,056048,I855
6838,SORICO,CO,1246,619,627,1030242030,013216,I856
6839,SORISO,NO,719,348,371,1010521330,003140,I857
6840,SORISOLE,BG,8901,4447,4454,1030121930,016202,I858
6841,SORMANO,CO,643,355,288,1030242040,013217,I860
6842,SORRADILE,OR,349,172,177,4200950630,095063,I861
6843,SORRENTO,,15600,7526,8074,3150510800,063080,I862
6844,SORSO,SS,14501,7321,7180,4200730670,090069,I863
6845,SORTINO,SR,8298,4105,4193,4190760190,089019,I864
6846,SOSPIRO,CR,3050,1546,1504,1030260960,019099,I865
6847,SOSPIROLO,BL,3053,1516,1537,1050100560,025056,I866
6848,SOSSANO,VI,4185,2131,2054,1050901020,024102,I867
6849,SOSTEGNO,BI,740,355,385,1010960640,096064,I868
6850,SOTTO IL MONTE GIOVANNI XXIII,BG,4401,2189,2212,1030121940,016203,I869
6851,SOVER,TN,773,406,367,1040831660,022177,I871
6852,SOVERATO,CZ,8683,4048,4635,3180221330,079137,I872
6853,SOVERE,BG,5229,2574,2655,1030121950,016204,I873
6854,SOVERIA MANNELLI,CZ,2903,1379,1524,3180221340,079138,I874
6855,SOVERIA SIMERI,CZ,1461,712,749,3180221350,079139,I875
6856,SOVERZENE,BL,364,177,187,1050100570,025057,I876
6857,SOVICILLE,SI,9906,4802,5104,2090750340,052034,I877
6858,SOVICO,MB,8314,4089,4225,1031040410,108041,I878
6859,SOVIZZO,VI,8283,4139,4144,1050901032,024128,M436
6860,SOVRAMONTE,BL,1311,646,665,1050100580,025058,I673
6861,SOZZAGO,NO,1088,515,573,1010521340,003141,I880
6862,SPADAFORA,ME,4682,2261,2421,4190480940,083096,I881
6863,SPADOLA,VV,799,401,398,3181030410,102041,I884
6864,SPARANISE,CE,7220,3506,3714,3150200890,061089,I885
6865,SPARONE,TO,928,452,476,1010812570,001267,I886
6866,SPECCHIA,LE,4602,2223,2379,3160410760,075077,I887
6867,SPELLO,PG,8314,4006,4308,2100580500,054050,I888
6868,SPERLINGA,EN,697,334,363,4190280170,086017,I891
6869,SPERLONGA,LT,3081,1543,1538,2120400300,059030,I892
6870,SPERONE,AV,3660,1784,1876,3150081020,064103,I893
6871,SPESSA,PV,554,264,290,1030571490,018152,I894
6872,SPEZZANO ALBANESE,CS,6636,3283,3353,3180251420,078142,I895
6873,SPEZZANO DELLA SILA,CS,4283,2164,2119,3180251430,078143,I896
6874,SPIAZZO,TN,1246,612,634,1040831680,022179,I899
6875,SPIGNO MONFERRATO,AL,923,464,459,1010021620,006165,I901
6876,SPIGNO SATURNIA,LT,2856,1380,1476,2120400310,059031,I902
6877,SPILAMBERTO,MO,12865,6428,6437,1080500440,036045,I903
6878,SPILIMBERGO,PN,11826,5755,6071,1060930440,093044,I904
6879,SPILINGA,VV,1345,670,675,3181030420,102042,I905
6880,SPINADESCO,CR,1476,723,753,1030260970,019100,I906
6881,SPINAZZOLA,BT,6027,2908,3119,3161060080,110008,I907
6882,SPINEA,VE,27749,13306,14443,1050870380,027038,I908
6883,SPINEDA,CR,600,298,302,1030260980,019101,I909
6884,SPINETE,CB,1186,591,595,3140190760,070076,I910
6885,SPINETO SCRIVIA,AL,367,182,185,1010021630,006166,I911
6886,SPINETOLI,AP,7219,3549,3670,2110060700,044071,I912
6887,SPINO D'ADDA,CR,6846,3423,3423,1030260990,019102,I914
6888,SPINONE AL LAGO,BG,965,468,497,1030121960,016205,I916
6889,SPINOSO,PZ,1355,662,693,3170640850,076086,I917
6890,SPIRANO,BG,5609,2827,2782,1030121970,016206,I919
6891,SPOLETO,PG,36467,17669,18798,2100580510,054051,I921
6892,SPOLTORE,PE,18935,9274,9661,3130600410,068041,I922
6893,SPONGANO,LE,3490,1673,1817,3160410770,075078,I923
6894,SPORMAGGIORE,TN,1270,676,594,1040831690,022180,I924
6895,SPORMINORE,TN,704,341,363,1040831700,022181,I925
6896,SPOTORNO,SV,3498,1665,1833,1070740570,009057,I926
6897,SPRESIANO,TV,12298,6082,6216,1050840810,026082,I927
6898,SPRIANA,SO,79,38,41,1030770620,014062,I928
6899,SQUILLACE,CZ,3543,1762,1781,3180221380,079142,I929
6900,SQUINZANO,LE,13482,6490,6992,3160410780,075079,I930
6901,STAFFOLO,AN,2087,1034,1053,2110030490,042049,I932
6902,STAGNO LOMBARDO,CR,1429,724,705,1030261000,019103,I935
6903,STAITI,RC,189,89,100,3180670900,080090,I936
6904,STALETTI',CZ,2320,1169,1151,3180221390,079143,I937
6905,STANGHELLA,PD,4138,2045,2093,1050540880,028088,I938
6906,STARANZANO,GO,7246,3604,3642,1060350190,031023,I939
6907,STATTE,TA,13136,6389,6747,3160780261,073029,M298
6908,STAZZANO,AL,2337,1144,1193,1010021640,006167,I941
6909,STAZZEMA,LU,2890,1436,1454,2090430300,046030,I942
6910,STAZZONA,CO,613,311,302,1030242050,013218,I943
6911,STEFANACONI,VV,2345,1163,1182,3181030430,102043,I945
6912,STELLA,SV,2937,1495,1442,1070740580,009058,I946
6913,STELLA CILENTO,SA,685,334,351,3150721440,065144,G887
6914,STELLANELLO,SV,852,444,408,1070740590,009059,I947
6915,STELVIO/STILFS,BZ,1139,589,550,1040140871,021095,I948
6916,STENICO,TN,1158,608,550,1040831710,022182,I949
6917,STERNATIA,LE,2179,1022,1157,3160410790,075080,I950
6918,STEZZANO,BG,13339,6592,6747,1030121980,016207,I951
6919,STIENTA,RO,3113,1561,1552,1050710450,029045,I953
6920,STIGLIANO,MT,3667,1727,1940,3170470260,077027,I954
6921,STIGNANO,RC,1231,629,602,3180670910,080091,I955
6922,STILO,RC,2404,1231,1173,3180670920,080092,I956
6923,STIMIGLIANO,RI,2203,1102,1101,2120690640,057066,I959
6924,STINTINO,SS,1538,790,748,4200730672,090089,M290
6925,STIO,SA,776,372,404,3150721450,065145,I960
6926,STORNARA,FG,5707,2877,2830,3160310520,071054,I962
6927,STORNARELLA,FG,5228,2564,2664,3160310530,071055,I963
6928,STORO,TN,4523,2194,2329,1040831720,022183,I964
6929,STRA,VE,7599,3694,3905,1050870390,027039,I965
6930,STRADELLA,PV,11406,5527,5879,1030571500,018153,I968
6931,STRAMBINELLO,TO,260,121,139,1010812580,001268,I969
6932,STRAMBINO,TO,6080,2952,3128,1010812590,001269,I970
6933,STRANGOLAGALLI,FR,2278,1098,1180,2120330740,060075,I973
6934,STREGNA,UD,304,166,138,1060851110,030111,I974
6935,STREMBO,TN,601,302,299,1040831730,022184,I975
6936,STRESA,VB,4627,2223,2404,1011020640,103064,I976
6937,STREVI,AL,1896,942,954,1010021650,006168,I977
6938,STRIANO,,8709,4393,4316,3150510810,063081,I978
6939,STRONA,BI,967,471,496,1010960650,096065,I980
6940,STRONCONE,TR,4638,2347,2291,2100800310,055031,I981
6941,STRONGOLI,KR,6163,3007,3156,3180970250,101025,I982
6942,STROPPIANA,VC,1172,571,601,1010881410,002142,I984
6943,STROPPO,CN,96,48,48,1010272240,004224,I985
6944,STROZZA,BG,1077,563,514,1030121990,016208,I986
6945,STURNO,AV,2817,1384,1433,3150081030,064104,I990
6946,SUARDI,PV,588,295,293,1030571510,018154,B014
6947,SUBBIANO,AR,6274,3139,3135,2090050370,051037,I991
6948,SUBIACO,RM,8538,4205,4333,2120701020,058103,I992
6949,SUCCIVO,CE,8705,4369,4336,3150200900,061090,I993
6950,SUEGLIO,LC,141,74,67,1030980770,097077,I994
6951,SUELLI,SU,1082,546,536,4201110880,111088,I995
6952,SUELLO,LC,1765,864,901,1030980780,097078,I996
6953,SUISIO,BG,3774,1911,1863,1030122000,016209,I997
6954,SULBIATE,MB,4417,2229,2188,1031040420,108042,I998
6955,SULMONA,AQ,22438,10861,11577,3130380970,066098,I804
6956,SULZANO,BS,1944,974,970,1030151720,017182,L002
6957,SUMIRAGO,VA,5974,2931,3043,1030861060,012124,L003
6958,SUMMONTE,AV,1512,759,753,3150081040,064105,L004
6959,SUNI,OR,994,474,520,4200950636,095087,L006
6960,SUNO,NO,2706,1343,1363,1010521360,003143,L007
6961,SUPERSANO,LE,4181,2064,2117,3160410800,075081,L008
6962,SUPINO,FR,4665,2314,2351,2120330750,060076,L009
6963,SURANO,LE,1542,726,816,3160410810,075082,L010
6964,SURBO,LE,14695,7148,7547,3160410820,075083,L011
6965,SUSA,TO,5940,2810,3130,1010812600,001270,L013
6966,SUSEGANA,TV,11740,5873,5867,1050840820,026083,L014
6967,SUSTINENTE,MN,2023,980,1043,1030450640,020064,L015
6968,SUTERA,CL,1209,578,631,4190180200,085020,L016
6969,SUTRI,VT,6597,3271,3326,2120910480,056049,L017
6970,SUTRIO,UD,1239,606,633,1060851120,030112,L018
6971,SUVERETO,LI,2980,1462,1518,2090420200,049020,L019
6972,SUZZARA,MN,20842,10385,10457,1030450650,020065,L020
6973,TACENO,LC,539,287,252,1030980790,097079,L022
6974,TADASUNI,OR,141,71,70,4200950640,095064,L023
6975,TAGGIA,IM,13766,6508,7258,1070370550,008059,L024
6976,TAGLIACOZZO,AQ,6449,3203,3246,3130380980,066099,L025
6977,TAGLIO DI PO,RO,7970,3963,4007,1050710460,029046,L026
6978,TAGLIOLO MONFERRATO,AL,1503,761,742,1010021660,006169,L027
6979,TAIBON AGORDINO,BL,1720,852,868,1050100590,025059,L030
6980,TAINO,VA,3621,1791,1830,1030861070,012125,L032
6981,TAIPANA,UD,565,303,262,1060851130,030113,G736
6982,TALAMELLO,RN,1067,518,549,1081010185,099027,L034
6983,TALAMONA,SO,4623,2273,2350,1030770630,014063,L035
6984,TALANA,NU,964,465,499,4200530850,091088,L036
6985,TALEGGIO,BG,539,290,249,1030122010,016210,L037
6986,TALLA,AR,975,516,459,2090050380,051038,L038
6987,TALMASSONS,UD,3878,1927,1951,1060851140,030114,L039
6988,TAMBRE,BL,1285,644,641,1050100600,025060,L040
6989,TAORMINA,ME,10473,5096,5377,4190480950,083097,L042
6990,TARANO,RI,1377,678,699,2120690650,057067,L046
6991,TARANTA PELIGNA,CH,329,169,160,3130230890,069089,L047
6992,TARANTASCA,CN,2166,1121,1045,1010272250,004225,L048
6993,TARANTO,TA,189461,90789,98672,3160780270,073027,L049
6994,TARCENTO,UD,8835,4234,4601,1060851160,030116,L050
6995,TARQUINIA,VT,16075,7846,8229,2120910490,056050,D024
6996,TARSIA,CS,1878,943,935,3180251450,078145,L055
6997,TARTANO,SO,196,109,87,1030770640,014064,L056
6998,TARVISIO,UD,3997,2040,1957,1060851170,030117,L057
6999,TARZO,TV,4226,2073,2153,1050840830,026084,L058
7000,TASSAROLO,AL,599,309,290,1010021670,006170,L059
7001,TAURANO,AV,1486,725,761,3150081050,064106,L061
7002,TAURASI,AV,2191,1085,1106,3150081060,064107,L062
7003,TAURIANOVA,RC,14947,7318,7629,3180670930,080093,L063
7004,TAURISANO,LE,11345,5447,5898,3160410830,075084,L064
7005,TAVAGNACCO,UD,14730,7007,7723,1060851180,030118,L065
7006,TAVAGNASCO,TO,745,359,386,1010812610,001271,L066
7007,TAVAZZANO CON VILLAVESCO,LO,5897,2907,2990,1030990560,098056,F260
7008,TAVENNA,CB,602,287,315,3140190770,070077,L069
7009,TAVERNA,CZ,2529,1274,1255,3180221420,079146,L070
7010,TAVERNERIO,CO,5700,2785,2915,1030242080,013222,L071
7011,TAVERNOLA BERGAMASCA,BG,1961,992,969,1030122020,016211,L073
7012,TAVERNOLE SUL MELLA,BS,1219,621,598,1030151730,017183,C698
7013,TAVIANO,LE,11551,5528,6023,3160410840,075085,L074
7014,TAVIGLIANO,BI,937,470,467,1010960660,096066,L075
7015,TAVOLETO,PU,831,404,427,2110590640,041064,L078
7016,TAVULLIA,PU,7883,3963,3920,2110590650,041065,L081
7017,TEANA,PZ,533,251,282,3170640860,076087,L082
7018,TEANO,CE,11448,5609,5839,3150200910,061091,L083
7019,TEGGIANO,SA,7186,3465,3721,3150721460,065146,D292
7020,TEGLIO,SO,4410,2153,2257,1030770650,014065,L084
7021,TEGLIO VENETO,VE,2256,1143,1113,1050870400,027040,L085
7022,TELESE TERME,BN,7645,3648,3997,3150110720,062074,L086
7023,TELGATE,BG,4978,2624,2354,1030122030,016212,L087
7024,TELTI,SS,2236,1121,1115,4200730671,090080,L088
7025,TELVE,TN,1886,922,964,1040831770,022188,L089
7026,TELVE DI SOPRA,TN,598,308,290,1040831780,022189,L090
7027,TEMPIO PAUSANIA,SS,13329,6683,6646,4200730680,090070,L093
7028,TEMU',BS,1105,560,545,1030151740,017184,L094
7029,TENNA,TN,1048,513,535,1040831790,022190,L096
7030,TENNO,TN,1984,957,1027,1040831800,022191,L097
7031,TEOLO,PD,8867,4355,4512,1050540890,028089,L100
7032,TEORA,AV,1463,739,724,3150081070,064108,L102
7033,TERAMO,TE,51849,25033,26816,3130790400,067041,L103
7034,TERDOBBIATE,NO,459,231,228,1010521370,003144,L104
7035,TERELLE,FR,312,154,158,2120330760,060077,L105
7036,TERENTO/TERENTEN,BZ,1779,927,852,1040140880,021096,L106
7037,TERENZO,PR,1162,596,566,1080560380,034038,E548
7038,TERGU,SS,606,294,312,4200730681,090086,M282
7039,TERLANO/TERLAN,BZ,4749,2384,2365,1040140890,021097,L108
7040,TERLIZZI,BA,26209,13012,13197,3160090420,072043,L109
7041,TERME VIGLIATORE,ME,7216,3556,3660,4190480951,083106,M210
7042,TERMENO SULLA STRADA DEL VINO/TRAMIN AN DER WEINSTRASSE,BZ,3396,1683,1713,1040140900,021098,L111
7043,TERMINI IMERESE,PA,25082,12255,12827,4190550680,082070,L112
7044,TERMOLI,CB,32391,15799,16592,3140190780,070078,L113
7045,TERNATE,VA,2485,1211,1274,1030861080,012126,L115
7046,TERNENGO,BI,260,126,134,1010960670,096067,L116
7047,TERNI,TR,107165,50926,56239,2100800320,055032,L117
7048,TERNO D'ISOLA,BG,8016,4030,3986,1030122040,016213,L118
7049,TERRACINA,LT,44504,22206,22298,2120400320,059032,L120
7050,TERRAGNOLO,TN,705,364,341,1040831820,022193,L121
7051,TERRALBA,OR,9792,4940,4852,4200950650,095065,L122
7052,TERRANOVA DA SIBARI,CS,4622,2308,2314,3180251460,078146,L124
7053,TERRANOVA DEI PASSERINI,LO,931,464,467,1030990570,098057,L125
7054,TERRANOVA DI POLLINO,PZ,1039,500,539,3170640870,076088,L126
7055,TERRANOVA SAPPO MINULIO,RC,460,234,226,3180670940,080094,L127
7056,TERRANUOVA BRACCIOLINI,AR,11983,5931,6052,2090050390,051039,L123
7057,TERRASINI,PA,12706,6279,6427,4190550690,082071,L131
7058,TERRASSA PADOVANA,PD,2677,1356,1321,1050540900,028090,L132
7059,TERRAVECCHIA,CS,610,297,313,3180251470,078147,L134
7060,TERRAZZO,VR,2140,1056,1084,1050890840,023085,L136
7061,TERRE D'ADIGE,TN,3043,1543,1500,1040831825,022251,M407
7062,TERRE DEL RENO,FE,9878,4845,5033,1080290185,038028,M381
7063,TERRE ROVERESCHE,PU,5147,2598,2549,2110590655,041070,M379
7064,TERRICCIOLA,PI,4460,2211,2249,2090620350,050036,L138
7065,TERRUGGIA,AL,912,428,484,1010021680,006171,L139
7066,TERTENIA,NU,3855,1922,1933,4200530860,091089,L140
7067,TERZIGNO,,17256,8688,8568,3150510820,063082,L142
7068,TERZO,AL,838,427,411,1010021690,006172,L143
7069,TERZO D'AQUILEIA,UD,2729,1322,1407,1060851200,030120,L144
7070,TERZOLAS,TN,636,306,330,1040831840,022195,L145
7071,TERZORIO,IM,235,114,121,1070370560,008060,L146
7072,TESERO,TN,2937,1462,1475,1040831850,022196,L147
7073,TESIMO/TISENS,BZ,1980,1004,976,1040140910,021099,L149
7074,TESSENNANO,VT,288,151,137,2120910500,056051,L150
7075,TESTICO,SV,177,90,87,1070740600,009060,L152
7076,TETI,NU,610,322,288,4200530870,091090,L153
7077,TEULADA,SU,3300,1704,1596,4201110890,111089,L154
7078,TEVEROLA,CE,14651,7223,7428,3150200920,061092,L155
7079,TEZZE SUL BRENTA,VI,12891,6431,6460,1050901040,024104,L156
7080,THIENE,VI,23945,11676,12269,1050901050,024105,L157
7081,THIESI,SS,2814,1413,1401,4200730690,090071,L158
7082,TIANA,NU,444,225,219,4200530880,091091,L160
7083,TICENGO,CR,417,205,212,1030261010,019104,L164
7084,TICINETO,AL,1307,625,682,1010021700,006173,L165
7085,TIGGIANO,LE,2753,1373,1380,3160410850,075086,L166
7086,TIGLIETO,GE,476,246,230,1070340610,010061,L167
7087,TIGLIOLE,AT,1703,852,851,1010071080,005108,L168
7088,TIGNALE,BS,1158,550,608,1030151750,017185,L169
7089,TINNURA,OR,239,119,120,4200950656,095088,L172
7090,TIONE DEGLI ABRUZZI,AQ,267,138,129,3130380990,066100,L173
7091,TIONE DI TRENTO,TN,3652,1808,1844,1040831880,022199,L174
7092,TIRANO,SO,8823,4236,4587,1030770660,014066,L175
7093,TIRES/TIERS,BZ,999,470,529,1040140920,021100,L176
7094,TIRIOLO,CZ,3605,1780,1825,3180221430,079147,L177
7095,TIROLO/TIROL,BZ,2462,1221,1241,1040140930,021101,L178
7096,TISSI,SS,2361,1191,1170,4200730700,090072,L180
7097,TITO,PZ,7147,3562,3585,3170640880,076089,L181
7098,TIVOLI,RM,55176,27121,28055,2120701030,058104,L182
7099,TIZZANO VAL PARMA,PR,2120,1071,1049,1080560390,034039,L183
7100,TOANO,RE,4123,2099,2024,1080680410,035041,L184
7101,TOCCO CAUDIO,BN,1440,711,729,3150110730,062075,L185
7102,TOCCO DA CASAURIA,PE,2422,1195,1227,3130600420,068042,L186
7103,TOCENO,VB,727,374,353,1011020650,103065,L187
7104,TODI,PG,15789,7636,8153,2100580520,054052,L188
7105,TOFFIA,RI,1089,557,532,2120690660,057068,L189
7106,TOIRANO,SV,2640,1282,1358,1070740610,009061,L190
7107,TOLENTINO,MC,18142,8778,9364,2110440530,043053,L191
7108,TOLFA,RM,4789,2409,2380,2120701040,058105,L192
7109,TOLLEGNO,BI,2383,1152,1231,1010960680,096068,L193
7110,TOLLO,CH,3928,1956,1972,3130230900,069090,L194
7111,TOLMEZZO,UD,9891,4720,5171,1060851210,030121,L195
7112,TOLVE,PZ,2990,1500,1490,3170640890,076090,L197
7113,TOMBOLO,PD,8240,4055,4185,1050540910,028091,L199
7114,TON,TN,1312,687,625,1040831890,022200,L200
7115,TONARA,NU,1812,896,916,4200530900,091093,L202
7116,TONCO,AT,774,398,376,1010071090,005109,L203
7117,TONEZZA DEL CIMONE,VI,501,254,247,1050901060,024106,D717
7118,TORA E PICCILLI,CE,792,382,410,3150200930,061093,L205
7119,TORANO CASTELLO,CS,4343,2156,2187,3180251480,078148,L206
7120,TORANO NUOVO,TE,1490,731,759,3130790410,067042,L207
7121,TORBOLE CASAGLIA,BS,6401,3215,3186,1030151760,017186,L210
7122,TORCEGNO,TN,684,342,342,1040831910,022202,L211
7123,TORCHIARA,SA,1824,889,935,3150721470,065147,L212
7124,TORCHIAROLO,BR,5241,2576,2665,3160160180,074018,L213
7125,TORELLA DEI LOMBARDI,AV,1970,973,997,3150081080,064109,L214
7126,TORELLA DEL SANNIO,CB,704,363,341,3140190790,070079,L215
7127,TORGIANO,PG,6640,3257,3383,2100580530,054053,L216
7128,TORGNON,AO,556,299,257,1020040660,007067,L217
7129,TORINO,TO,848748,407062,441686,1010812620,001272,L219
7130,TORINO DI SANGRO,CH,2945,1442,1503,3130230910,069091,L218
7131,TORITTO,BA,8061,3978,4083,3160090430,072044,L220
7132,TORLINO VIMERCATI,CR,480,236,244,1030261020,019105,L221
7133,TORNACO,NO,875,425,450,1010521390,003146,L223
7134,TORNARECCIO,CH,1663,831,832,3130230920,069092,L224
7135,TORNATA,CR,426,234,192,1030261030,019106,L225
7136,TORNIMPARTE,AQ,2847,1444,1403,3130381000,066101,L227
7137,TORNO,CO,1106,545,561,1030242090,013223,L228
7138,TORNOLO,PR,915,487,428,1080560400,034040,L229
7139,TORO,CB,1243,608,635,3140190800,070080,L230
7140,TORPE',NU,2720,1412,1308,4200530910,091094,L231
7141,TORRACA,SA,1185,586,599,3150721480,065148,L233
7142,TORRALBA,SS,904,450,454,4200730710,090073,L235
7143,TORRAZZA COSTE,PV,1569,780,789,1030571520,018155,L237
7144,TORRAZZA PIEMONTE,TO,3000,1479,1521,1010812630,001273,L238
7145,TORRAZZO,BI,205,108,97,1010960690,096069,L239
7146,TORRE ANNUNZIATA,,40523,19508,21015,3150510830,063083,L245
7147,TORRE BERETTI E CASTELLARO,PV,507,270,237,1030571530,018156,L250
7148,TORRE BOLDONE,BG,8620,4142,4478,1030122050,016214,L251
7149,TORRE BORMIDA,CN,162,79,83,1010272260,004226,L252
7150,TORRE CAJETANI,FR,1315,672,643,2120330770,060078,L243
7151,TORRE CANAVESE,TO,620,300,320,1010812631,001274,L247
7152,TORRE D'ARESE,PV,929,493,436,1030571540,018157,L256
7153,TORRE D'ISOLA,PV,2387,1181,1206,1030571560,018159,L269
7154,TORRE DE' BUSI,BG,2183,1109,1074,1030122061,016215,L257
7155,TORRE DE' NEGRI,PV,313,148,165,1030571550,018158,L262
7156,TORRE DE' PASSERI,PE,2883,1412,1471,3130600430,068043,L263
7157,TORRE DE' PICENARDI,CR,2103,1058,1045,1030261040,019107,L258
7158,TORRE DE' ROVERI,BG,2526,1258,1268,1030122070,016216,L265
7159,TORRE DEL GRECO,,81289,39341,41948,3150510840,063084,L259
7160,TORRE DI MOSTO,VE,4766,2377,2389,1050870410,027041,L267
7161,TORRE DI RUGGIERO,CZ,961,452,509,3180221440,079148,L240
7162,TORRE DI SANTA MARIA,SO,745,369,376,1030770670,014067,L244
7163,TORRE LE NOCELLE,AV,1202,600,602,3150081090,064110,L272
7164,TORRE MONDOVI',CN,489,256,233,1010272270,004227,L241
7165,TORRE ORSAIA,SA,1982,976,1006,3150721490,065149,L274
7166,TORRE PALLAVICINA,BG,1127,569,558,1030122080,016217,L276
7167,TORRE PELLICE,TO,4591,2185,2406,1010812640,001275,L277
7168,TORRE SAN GIORGIO,CN,744,367,377,1010272280,004228,L278
7169,TORRE SAN PATRIZIO,FM,1884,921,963,2111050400,109040,L279
7170,TORRE SANTA SUSANNA,BR,10151,4954,5197,3160160190,074019,L280
7171,TORREANO,UD,2068,1008,1060,1060851220,030122,L246
7172,TORREBELVICINO,VI,5817,2952,2865,1050901070,024107,L248
7173,TORREBRUNA,CH,717,338,379,3130230930,069093,L253
7174,TORRECUSO,BN,3260,1619,1641,3150110740,062076,L254
7175,TORREGLIA,PD,6110,3035,3075,1050540920,028092,L270
7176,TORREGROTTA,ME,7268,3452,3816,4190480960,083098,L271
7177,TORREMAGGIORE,FG,16567,8199,8368,3160310540,071056,L273
7178,TORRENOVA,ME,4484,2179,2305,4190480961,083108,M286
7179,TORRESINA,CN,48,21,27,1010272290,004229,L281
7180,TORRETTA,PA,4201,2056,2145,4190550700,082072,L282
7181,TORREVECCHIA PIA,PV,3480,1784,1696,1030571570,018160,L285
7182,TORREVECCHIA TEATINA,CH,4206,2092,2114,3130230940,069094,L284
7183,TORRI DEL BENACO,VR,2967,1427,1540,1050890850,023086,L287
7184,TORRI DI QUARTESOLO,VI,11738,5799,5939,1050901080,024108,L297
7185,TORRI IN SABINA,RI,1221,627,594,2120690680,057070,L286
7186,TORRICE,FR,4733,2322,2411,2120330780,060079,L290
7187,TORRICELLA,TA,4165,2073,2092,3160780280,073028,L294
7188,TORRICELLA DEL PIZZO,CR,574,290,284,1030261050,019108,L296
7189,TORRICELLA IN SABINA,RI,1333,705,628,2120690670,057069,L293
7190,TORRICELLA PELIGNA,CH,1152,546,606,3130230950,069095,L291
7191,TORRICELLA SICURA,TE,2460,1228,1232,3130790420,067043,L295
7192,TORRICELLA VERZATE,PV,816,408,408,1030571580,018161,L292
7193,TORRIGLIA,GE,2195,1081,1114,1070340620,010062,L298
7194,TORRILE,PR,7686,3858,3828,1080560410,034041,L299
7195,TORRIONI,AV,456,252,204,3150081100,064111,L301
7196,TORRITA DI SIENA,SI,7014,3436,3578,2090750350,052035,L303
7197,TORRITA TIBERINA,RM,1079,526,553,2120701050,058106,L302
7198,TORTOLI',NU,11024,5411,5613,4200530920,091095,A355
7199,TORTONA,AL,26461,12746,13715,1010021710,006174,L304
7200,TORTORA,CS,5949,2901,3048,3180251490,078149,L305
7201,TORTORELLA,SA,473,231,242,3150721500,065150,L306
7202,TORTORETO,TE,11846,5735,6111,3130790430,067044,L307
7203,TORTORICI,ME,5792,2855,2937,4190480970,083099,L308
7204,TORVISCOSA,UD,2648,1293,1355,1060851230,030123,L309
7205,TOSCOLANO-MADERNO,BS,7550,3660,3890,1030151770,017187,L312
7206,TOSSICIA,TE,1258,600,658,3130790440,067045,L314
7207,TOVO DI SANT'AGATA,SO,626,317,309,1030770680,014068,L316
7208,TOVO SAN GIACOMO,SV,2504,1221,1283,1070740620,009062,L315
7209,TRABIA,PA,10505,5341,5164,4190550710,082073,L317
7210,TRADATE,VA,18834,9273,9561,1030861090,012127,L319
7211,TRAMATZA,OR,937,475,462,4200950660,095066,L321
7212,TRAMBILENO,TN,1467,729,738,1040831920,022203,L322
7213,TRAMONTI,SA,4092,2034,2058,3150721510,065151,L323
7214,TRAMONTI DI SOPRA,PN,271,132,139,1060930450,093045,L324
7215,TRAMONTI DI SOTTO,PN,339,175,164,1060930460,093046,L325
7216,TRAMUTOLA,PZ,2941,1434,1507,3170640900,076091,L326
7217,TRANA,TO,3813,1873,1940,1010812650,001276,L327
7218,TRANI,BT,55035,27247,27788,3161060090,110009,L328
7219,TRAONA,SO,2842,1453,1389,1030770690,014069,L330
7220,TRAPANI,TP,56293,27168,29125,4190820210,081021,L331
7221,TRAPPETO,PA,3055,1514,1541,4190550711,082074,L332
7222,TRAREGO VIGGIONA,VB,409,212,197,1011020660,103066,L333
7223,TRASACCO,AQ,5897,3006,2891,3130381010,066102,L334
7224,TRASAGHIS,UD,2099,1044,1055,1060851240,030124,L335
7225,TRASQUERA,VB,182,89,93,1011020670,103067,L336
7226,TRATALIAS,SU,1020,525,495,4201110900,111090,L337
7227,TRAVACO' SICCOMARIO,PV,4402,2134,2268,1030571590,018162,I236
7228,TRAVAGLIATO,BS,13725,6811,6914,1030151780,017188,L339
7229,TRAVEDONA-MONATE,VA,3949,1926,2023,1030861100,012128,L342
7230,TRAVERSELLA,TO,319,164,155,1010812680,001278,L345
7231,TRAVERSETOLO,PR,9454,4686,4768,1080560420,034042,L346
7232,TRAVES,TO,486,252,234,1010812681,001279,L340
7233,TRAVESIO,PN,1783,881,902,1060930470,093047,L347
7234,TRAVO,PC,2165,1083,1082,1080610430,033043,L348
7235,TRE VILLE,TN,1365,672,693,1040831955,022247,M361
7236,TREBASELEGHE,PD,12889,6475,6414,1050540930,028093,L349
7237,TREBISACCE,CS,8593,4180,4413,3180251500,078150,L353
7238,TRECASE,,8594,4195,4399,3150510841,063091,M280
7239,TRECASTAGNI,CT,11230,5555,5675,4190210490,087050,L355
7240,TRECASTELLI,AN,7442,3737,3705,2110030500,042050,M318
7241,TRECATE,NO,20496,10237,10259,1010521420,003149,L356
7242,TRECCHINA,PZ,2182,1040,1142,3170640910,076092,L357
7243,TRECENTA,RO,2591,1255,1336,1050710470,029047,L359
7244,TREDOZIO,FC,1121,547,574,1080320480,040049,L361
7245,TREGLIO,CH,1730,844,886,3130230960,069096,L363
7246,TREGNAGO,VR,4969,2437,2532,1050890860,023087,L364
7247,TREIA,MC,9093,4516,4577,2110440540,043054,L366
7248,TREISO,CN,761,388,373,1010272291,004230,L367
7249,TREMESTIERI ETNEO,CT,19851,9414,10437,4190210500,087051,L369
7250,TREMEZZINA,CO,5027,2482,2545,1030242105,013252,M341
7251,TREMOSINE SUL GARDA,BS,2046,1035,1011,1030151790,017189,L372
7252,TRENTINARA,SA,1572,786,786,3150721520,065152,L377
7253,TRENTO,TN,117847,57025,60822,1040831940,022205,L378
7254,TRENTOLA DUCENTA,CE,20137,9897,10240,3150200940,061094,L379
7255,TRENZANO,BS,5470,2763,2707,1030151800,017190,L380
7256,TREPPO GRANDE,UD,1699,818,881,1060851260,030126,L382
7257,TREPPO LIGOSULLO,UD,682,346,336,1060851265,030191,M399
7258,TREPUZZI,LE,14099,6742,7357,3160410860,075087,L383
7259,TREQUANDA,SI,1195,594,601,2090750360,052036,L384
7260,TRESANA,MS,1952,968,984,2090460150,045015,L386
7261,TRESCORE BALNEARIO,BG,9711,4870,4841,1030122090,016218,L388
7262,TRESCORE CREMASCO,CR,2794,1374,1420,1030261060,019109,L389
7263,TRESIGNANA,FE,6951,3333,3618,1080290195,038030,M409
7264,TRESIVIO,SO,2011,999,1012,1030770700,014070,L392
7265,TRESNURAGHES,OR,1051,509,542,4200950670,095067,L393
7266,TREVENZUOLO,VR,2757,1428,1329,1050890870,023088,L396
7267,TREVI,PG,8127,3954,4173,2100580540,054054,L397
7268,TREVI NEL LAZIO,FR,1749,909,840,2120330790,060080,L398
7269,TREVICO,AV,867,425,442,3150081110,064112,L399
7270,TREVIGLIO,BG,30567,15018,15549,1030122100,016219,L400
7271,TREVIGNANO,TV,10722,5375,5347,1050840840,026085,L402
7272,TREVIGNANO ROMANO,RM,5832,2839,2993,2120701060,058107,L401
7273,TREVILLE,AL,258,126,132,1010021720,006175,L403
7274,TREVIOLO,BG,10857,5294,5563,1030122110,016220,L404
7275,TREVISO,TV,84452,40387,44065,1050840850,026086,L407
7276,TREVISO BRESCIANO,BS,507,249,258,1030151810,017191,L406
7277,TREZZANO ROSA,MI,5374,2685,2689,1030492180,015219,L408
7278,TREZZANO SUL NAVIGLIO,MI,21460,10462,10998,1030492190,015220,L409
7279,TREZZO SULL'ADDA,MI,11930,5835,6095,1030492200,015221,L411
7280,TREZZO TINELLA,CN,303,162,141,1010272300,004231,L410
7281,TREZZONE,CO,237,124,113,1030242120,013226,L413
7282,TRIBANO,PD,4247,2135,2112,1050540940,028094,L414
7283,TRIBIANO,MI,3672,1865,1807,1030492210,015222,L415
7284,TRIBOGNA,GE,566,296,270,1070340630,010063,L416
7285,TRICARICO,MT,4857,2380,2477,3170470270,077028,L418
7286,TRICASE,LE,17142,8269,8873,3160410870,075088,L419
7287,TRICERRO,VC,680,347,333,1010881450,002147,L420
7288,TRICESIMO,UD,7596,3619,3977,1060851270,030127,L421
7289,TRIEI,NU,1071,546,525,4200530940,091097,L423
7290,TRIESTE,TS,199015,95818,103197,1060920060,032006,L424
7291,TRIGGIANO,BA,26113,12621,13492,3160090450,072046,L425
7292,TRIGOLO,CR,1638,786,852,1030261070,019110,L426
7293,TRINITA',CN,2231,1104,1127,1010272310,004232,L427
7294,TRINITA' D'AGULTU E VIGNOLA,SS,2239,1106,1133,4200730711,090074,L428
7295,TRINITAPOLI,BT,13970,6814,7156,3161060100,110010,B915
7296,TRINO,VC,6692,3312,3380,1010881460,002148,L429
7297,TRIORA,IM,360,207,153,1070370570,008061,L430
7298,TRIPI,ME,755,348,407,4190480980,083100,L431
7299,TRISOBBIO,AL,667,331,336,1010021730,006176,L432
7300,TRISSINO,VI,8638,4335,4303,1050901100,024110,L433
7301,TRIUGGIO,MB,8668,4316,4352,1031040430,108043,L434
7302,TRIVENTO,CB,4437,2196,2241,3140190810,070081,L435
7303,TRIVIGLIANO,FR,1631,803,828,2120330800,060081,L437
7304,TRIVIGNANO UDINESE,UD,1564,774,790,1060851280,030128,L438
7305,TRIVIGNO,PZ,588,283,305,3170640920,076093,L439
7306,TRIVOLZIO,PV,2364,1207,1157,1030571600,018163,L440
7307,TRODENA NEL PARCO NATURALE/TRUDEN IM NATURPARK,BZ,1045,514,531,1040140940,021102,L444
7308,TROFARELLO,TO,10580,5133,5447,1010812690,001280,L445
7309,TROIA,FG,6771,3287,3484,3160310560,071058,L447
7310,TROINA,EN,8642,4177,4465,4190280180,086018,L448
7311,TROMELLO,PV,3647,1785,1862,1030571610,018164,L449
7312,TRONTANO,VB,1632,821,811,1011020680,103068,L450
7313,TRONZANO LAGO MAGGIORE,VA,225,117,108,1030861110,012129,A705
7314,TRONZANO VERCELLESE,VC,3318,1623,1695,1010881480,002150,L451
7315,TROPEA,VV,5911,2842,3069,3181030440,102044,L452
7316,TROVO,PV,1017,524,493,1030571620,018165,L453
7317,TRUCCAZZANO,MI,5844,3012,2832,1030492230,015224,L454
7318,TUBRE/TAUFERS IM MUNSTERTAL,BZ,962,462,500,1040140950,021103,L455
7319,TUFARA,CB,798,391,407,3140190820,070082,L458
7320,TUFILLO,CH,357,171,186,3130230970,069097,L459
7321,TUFINO,,3427,1693,1734,3150510850,063085,L460
7322,TUFO,AV,795,395,400,3150081120,064113,L461
7323,TUGLIE,LE,5067,2440,2627,3160410880,075089,L462
7324,TUILI,SU,948,466,482,4201110910,111091,L463
7325,TULA,SS,1466,742,724,4200730720,090075,L464
7326,TUORO SUL TRASIMENO,PG,3743,1833,1910,2100580550,054055,L466
7327,TURANIA,RI,223,133,90,2120690690,057071,G507
7328,TURANO LODIGIANO,LO,1500,762,738,1030990580,098058,L469
7329,TURATE,CO,9555,4771,4784,1030242130,013227,L470
7330,TURBIGO,MI,7046,3467,3579,1030492250,015226,L471
7331,TURI,BA,12928,6270,6658,3160090460,072047,L472
7332,TURRI,SU,391,200,191,4201110920,111092,L473
7333,TURRIACO,GO,2806,1375,1431,1060350200,031024,L474
7334,TURRIVALIGNANI,PE,790,383,407,3130600440,068044,L475
7335,TURSI,MT,4753,2384,2369,3170470280,077029,L477
7336,TUSA,ME,2638,1319,1319,4190480990,083101,L478
7337,TUSCANIA,VT,8242,3970,4272,2120910510,056052,L310
7338,UBIALE CLANEZZO,BG,1353,696,657,1030122120,016221,C789
7339,UBOLDO,VA,10719,5371,5348,1030861120,012130,L480
7340,UCRIA,ME,924,432,492,4190481000,083102,L482
7341,UDINE,UD,97736,45971,51765,1060851290,030129,L483
7342,UGENTO,LE,12075,5816,6259,3160410890,075090,L484
7343,UGGIANO LA CHIESA,LE,4347,2067,2280,3160410900,075091,L485
7344,UGGIATE CON RONAGO,CO,6667,3279,3388,1030242142,013256,M435
7345,ULA TIRSO,OR,475,230,245,4200950680,095068,L488
7346,ULASSAI,NU,1369,661,708,4200530950,091098,L489
7347,ULTIMO/ULTEN,BZ,2897,1472,1425,1040140960,021104,L490
7348,UMBERTIDE,PG,16358,7982,8376,2100580560,054056,D786
7349,UMBRIATICO,KR,755,377,378,3180970260,101026,L492
7350,URAGO D'OGLIO,BS,3733,1929,1804,1030151820,017192,L494
7351,URAS,OR,2697,1346,1351,4200950690,095069,L496
7352,URBANA,PD,2044,1016,1028,1050540950,028095,L497
7353,URBANIA,PU,6888,3351,3537,2110590660,041066,L498
7354,URBE,SV,653,330,323,1070740630,009063,L499
7355,URBINO,PU,13772,6797,6975,2110590670,041067,L500
7356,URBISAGLIA,MC,2439,1210,1229,2110440550,043055,L501
7357,URGNANO,BG,9821,5008,4813,1030122130,016222,L502
7358,URI,SS,2856,1471,1385,4200730730,090076,L503
7359,URURI,CB,2470,1188,1282,3140190830,070083,L505
7360,URZULEI,NU,1125,565,560,4200530960,091099,L506
7361,USCIO,GE,2141,1059,1082,1070340640,010064,L507
7362,USELLUS,OR,727,372,355,4200950700,095070,L508
7363,USINI,SS,4237,2125,2112,4200730740,090077,L509
7364,USMATE VELATE,MB,10483,5190,5293,1031040440,108044,L511
7365,USSANA,SU,4023,1999,2024,4201110930,111093,L512
7366,USSARAMANNA,SU,492,253,239,4201110940,111094,L513
7367,USSASSAI,NU,473,242,231,4200530970,091100,L514
7368,USSEAUX,TO,178,90,88,1010812710,001281,L515
7369,USSEGLIO,TO,195,103,92,1010812720,001282,L516
7370,USSITA,MC,378,184,194,2110440560,043056,L517
7371,USTICA,PA,1307,660,647,4190550720,082075,L519
7372,UTA,CA,8671,4413,4258,4200170900,092090,L521
7373,UZZANO,PT,5609,2712,2897,2090630210,047021,L522
7374,VACCARIZZO ALBANESE,CS,1029,498,531,3180251520,078152,L524
7375,VACONE,RI,226,113,113,2120690700,057072,L525
7376,VACRI,CH,1526,747,779,3130230980,069098,L526
7377,VADENA/PFATTEN,BZ,1076,573,503,1040140970,021105,L527
7378,VADO LIGURE,SV,8105,3916,4189,1070740640,009064,L528
7379,VAGLI SOTTO,LU,839,438,401,2090430310,046031,L533
7380,VAGLIA,FI,5208,2547,2661,2090300460,048046,L529
7381,VAGLIO BASILICATA,PZ,1880,909,971,3170640930,076094,L532
7382,VAGLIO SERRA,AT,276,136,140,1010071110,005111,L531
7383,VAIANO,PO,9943,4842,5101,2091000060,100006,L537
7384,VAIANO CREMASCO,CR,3554,1795,1759,1030261080,019111,L535
7385,VAIE,TO,1389,687,702,1010812730,001283,L538
7386,VAILATE,CR,4600,2306,2294,1030261090,019112,L539
7387,VAIRANO PATENORA,CE,6307,3050,3257,3150200950,061095,L540
7388,VAJONT,PN,1669,835,834,1060930471,093052,M265
7389,VAL BREMBILLA,BG,4156,2102,2054,1030122145,016253,M334
7390,VAL DELLA TORRE,TO,3982,2011,1971,1010812740,001284,L555
7391,VAL DI CHY,TO,1235,633,602,1010812745,001317,M405
7392,VAL DI NIZZA,PV,579,288,291,1030571630,018166,L562
7393,VAL DI VIZZE/PFITSCH,BZ,3065,1535,1530,1040140990,021107,L564
7394,VAL DI ZOLDO,BL,2817,1377,1440,1050100615,025073,M374
7395,VAL LIONA,VI,3060,1567,1493,1050901105,024123,M384
7396,VAL MASINO,SO,841,444,397,1030770740,014074,L638
7397,VAL REZZO,CO,162,82,80,1030242190,013233,H259
7398,VALBONDIONE,BG,968,482,486,1030122140,016223,L544
7399,VALBREMBO,BG,4352,2147,2205,1030122150,016224,L545
7400,VALBRENTA,VI,4870,2502,2368,1050901108,024125,M423
7401,VALBREVENNA,GE,757,420,337,1070340650,010065,L546
7402,VALBRONA,CO,2625,1304,1321,1030242150,013229,L547
7403,VALCHIUSA,TO,1003,485,518,1010812735,001318,M415
7404,VALDAGNO,VI,25697,12481,13216,1050901110,024111,L551
7405,VALDAONE,TN,1149,600,549,1040831975,022232,M343
7406,VALDAORA/OLANG,BZ,3166,1618,1548,1040140981,021106,L552
7407,VALDASTICO,VI,1175,565,610,1050901120,024112,L554
7408,VALDENGO,BI,2396,1174,1222,1010960710,096071,L556
7409,VALDERICE,TP,11551,5719,5832,4190820211,081022,G319
7410,VALDIDENTRO,SO,4134,2090,2044,1030770710,014071,L557
7411,VALDIERI,CN,912,460,452,1010272320,004233,L558
7412,VALDILANA,BI,10235,4989,5246,1010960715,096088,M417
7413,VALDINA,ME,1268,629,639,4190481010,083103,L561
7414,VALDISOTTO,SO,3594,1817,1777,1030770720,014072,L563
7415,VALDOBBIADENE,TV,10002,4838,5164,1050840860,026087,L565
7416,VALDUGGIA,VC,1875,926,949,1010881500,002152,L566
7417,VALEGGIO,PV,195,108,87,1030571640,018167,L568
7418,VALEGGIO SUL MINCIO,VR,15857,7851,8006,1050890880,023089,L567
7419,VALENTANO,VT,2762,1374,1388,2120910520,056053,L569
7420,VALENZA,AL,18090,8627,9463,1010021740,006177,L570
7421,VALENZANO,BA,17457,8484,8973,3160090470,072048,L571
7422,VALERA FRATTA,LO,1730,882,848,1030990590,098059,L572
7423,VALFABBRICA,PG,3246,1588,1658,2100580570,054057,L573
7424,VALFENERA,AT,2416,1227,1189,1010071120,005112,L574
7425,VALFLORIANA,TN,474,241,233,1040831980,022209,L575
7426,VALFORNACE,MC,921,456,465,2110440565,043058,M382
7427,VALFURVA,SO,2498,1240,1258,1030770730,014073,L576
7428,VALGANNA,VA,1595,792,803,1030861130,012131,L577
7429,VALGIOIE,TO,976,530,446,1010812742,001285,L578
7430,VALGOGLIO,BG,585,299,286,1030122151,016225,L579
7431,VALGRANA,CN,808,413,395,1010272330,004234,L580
7432,VALGREGHENTINO,LC,3405,1718,1687,1030980820,097082,L581
7433,VALGRISENCHE,AO,192,111,81,1020040670,007068,L582
7434,VALGUARNERA CAROPEPE,EN,7082,3322,3760,4190280190,086019,L583
7435,VALLADA AGORDINA,BL,466,220,246,1050100620,025062,L584
7436,VALLANZENGO,BI,206,100,106,1010960720,096072,L586
7437,VALLARSA,TN,1383,706,677,1040831990,022210,L588
7438,VALLATA,AV,2540,1249,1291,3150081130,064114,L589
7439,VALLE AGRICOLA,CE,766,373,393,3150200960,061096,L594
7440,VALLE AURINA/AHRNTAL,BZ,5989,3069,2920,1040141000,021108,L595
7441,VALLE CANNOBINA,VB,465,239,226,1011020685,103079,M404
7442,VALLE CASTELLANA,TE,880,470,410,3130790450,067046,L597
7443,VALLE DELL'ANGELO,SA,220,115,105,3150721530,065153,G540
7444,VALLE DI CADORE,BL,1862,900,962,1050100630,025063,L590
7445,VALLE DI CASIES/GSIES,BZ,2339,1185,1154,1040141010,021109,L601
7446,VALLE DI MADDALONI,CE,2643,1298,1345,3150200970,061097,L591
7447,VALLE LOMELLINA,PV,2066,1057,1009,1030571650,018168,L593
7448,VALLE SALIMBENE,PV,1451,729,722,1030571660,018169,L617
7449,VALLE SAN NICOLAO,BI,881,443,438,1010960740,096074,L620
7450,VALLEBONA,IM,1257,642,615,1070370580,008062,L596
7451,VALLECORSA,FR,2438,1199,1239,2120330810,060082,L598
7452,VALLECROSIA,IM,6727,3185,3542,1070370590,008063,L599
7453,VALLEDOLMO,PA,3227,1548,1679,4190550730,082076,L603
7454,VALLEDORIA,SS,4264,2150,2114,4200730741,090079,L604
7455,VALLEFIORITA,CZ,1531,714,817,3180221470,079151,I322
7456,VALLEFOGLIA,PU,14917,7514,7403,2110590680,041068,M331
7457,VALLELAGHI,TN,5176,2606,2570,1040831995,022248,M362
7458,VALLELONGA,VV,719,372,347,3181030450,102045,L607
7459,VALLELUNGA PRATAMENO,CL,3164,1505,1659,4190180210,085021,L609
7460,VALLEMAIO,FR,892,437,455,2120330820,060083,L605
7461,VALLEPIETRA,RM,248,117,131,2120701070,058108,L611
7462,VALLERANO,VT,2442,1210,1232,2120910530,056054,L612
7463,VALLERMOSA,SU,1810,929,881,4201110950,111095,L613
7464,VALLEROTONDA,FR,1414,704,710,2120330830,060084,L614
7465,VALLESACCARDA,AV,1250,609,641,3150081131,064115,L616
7466,VALLEVE,BG,127,71,56,1030122160,016226,L623
7467,VALLI DEL PASUBIO,VI,3064,1569,1495,1050901130,024113,L624
7468,VALLINFREDA,RM,298,158,140,2120701080,058109,L625
7469,VALLIO TERME,BS,1410,706,704,1030151830,017193,L626
7470,VALLO DELLA LUCANIA,SA,8084,3823,4261,3150721540,065154,L628
7471,VALLO DI NERA,PG,340,165,175,2100580580,054058,L627
7472,VALLO TORINESE,TO,780,397,383,1010812741,001286,L629
7473,VALLORIATE,CN,99,55,44,1010272340,004235,L631
7474,VALMACCA,AL,966,455,511,1010021750,006178,L633
7475,VALMADRERA,LC,11161,5480,5681,1030980830,097083,L634
7476,VALMONTONE,RM,15698,7763,7935,2120701090,058110,L639
7477,VALMOREA,CO,2583,1271,1312,1030242180,013232,L640
7478,VALMOZZOLA,PR,530,269,261,1080560440,034044,L641
7479,VALNEGRA,BG,215,111,104,1030122161,016227,L642
7480,VALPELLINE,AO,591,314,277,1020040680,007069,L643
7481,VALPERGA,TO,2974,1415,1559,1010812750,001287,L644
7482,VALPRATO SOANA,TO,90,49,41,1010812760,001288,B510
7483,VALSAMOGGIA,BO,31605,15707,15898,1080130585,037061,M320
7484,VALSAVARENCHE,AO,166,87,79,1020040690,007070,L647
7485,VALSINNI,MT,1373,662,711,3170470290,077030,D513
7486,VALSOLDA,CO,1426,702,724,1030242200,013234,C936
7487,VALSTRONA,VB,1163,581,582,1011020690,103069,L651
7488,VALTOPINA,PG,1271,616,655,2100580590,054059,L653
7489,VALTORTA,BG,249,131,118,1030122180,016229,L655
7490,VALTOURNENCHE,AO,2198,1157,1041,1020040700,007071,L654
7491,VALVA,SA,1551,785,766,3150721550,065155,L656
7492,VALVARRONE,LC,508,262,246,1030980835,097093,M395
7493,VALVASONE ARZENE,PN,3917,1951,1966,1060930476,093053,M346
7494,VALVERDE,CT,7838,3884,3954,4190210501,087052,L658
7495,VALVESTINO,BS,173,84,89,1030151850,017194,L468
7496,VANDOIES/VINTL,BZ,3308,1678,1630,1040141020,021110,L660
7497,VANZAGHELLO,MI,5262,2565,2697,1030492271,015249,L664
7498,VANZAGO,MI,9327,4545,4782,1030492280,015229,L665
7499,VANZONE CON SAN CARLO,VB,390,195,195,1011020700,103070,L666
7500,VAPRIO D'ADDA,MI,9462,4770,4692,1030492290,015230,L667
7501,VAPRIO D'AGOGNA,NO,967,470,497,1010521460,003153,L668
7502,VARALLO,VC,6926,3317,3609,1010881540,002156,L669
7503,VARALLO POMBIA,NO,4946,2416,2530,1010521470,003154,L670
7504,VARANO BORGHI,VA,2455,1175,1280,1030861150,012132,L671
7505,VARANO DE' MELEGARI,PR,2592,1283,1309,1080560450,034045,L672
7506,VARAPODIO,RC,1997,984,1013,3180670950,080095,L673
7507,VARAZZE,SV,12620,6099,6521,1070740650,009065,L675
7508,VARCO SABINO,RI,165,92,73,2120690710,057073,L676
7509,VAREDO,MB,13619,6631,6988,1031040450,108045,L677
7510,VARENNA,LC,725,367,358,1030980840,097084,L680
7511,VARESE,VA,78740,37414,41326,1030861160,012133,L682
7512,VARESE LIGURE,SP,1811,895,916,1070390290,011029,L681
7513,VARISELLA,TO,850,426,424,1010812761,001289,L685
7514,VARMO,UD,2642,1335,1307,1060851300,030130,L686
7515,VARNA/VAHRN,BZ,4894,2477,2417,1040141030,021111,L687
7516,VARSI,PR,1138,568,570,1080560460,034046,L689
7517,VARZI,PV,3013,1470,1543,1030571670,018171,L690
7518,VARZO,VB,1940,941,999,1011020710,103071,L691
7519,VASANELLO,VT,3979,1965,2014,2120910540,056055,A701
7520,VASIA,IM,366,179,187,1070370600,008064,L693
7521,VASTO,CH,40565,19799,20766,3130230990,069099,E372
7522,VASTOGIRARDI,IS,634,322,312,3140940510,094051,L696
7523,VAUDA CANAVESE,TO,1435,726,709,1010812770,001290,L698
7524,VAZZANO,VV,964,458,506,3181030460,102046,L699
7525,VAZZOLA,TV,6746,3405,3341,1050840870,026088,L700
7526,VECCHIANO,PI,11910,5765,6145,2090620360,050037,L702
7527,VEDANO AL LAMBRO,MB,7504,3580,3924,1031040460,108046,L704
7528,VEDANO OLONA,VA,7281,3497,3784,1030861170,012134,L703
7529,VEDELAGO,TV,16554,8347,8207,1050840880,026089,L706
7530,VEDESETA,BG,187,101,86,1030122190,016230,L707
7531,VEDUGGIO CON COLZANO,MB,4216,2120,2096,1031040470,108047,L709
7532,VEGGIANO,PD,4802,2441,2361,1050540960,028096,L710
7533,VEGLIE,LE,13421,6496,6925,3160410910,075092,L711
7534,VEGLIO,BI,454,234,220,1010960750,096075,L712
7535,VEJANO,VT,2154,1074,1080,2120910550,056056,L713
7536,VELESO,CO,203,102,101,1030242220,013236,L715
7537,VELEZZO LOMELLINA,PV,96,51,45,1030571680,018172,L716
7538,VELLETRI,RM,52472,25655,26817,2120701100,058111,L719
7539,VELLEZZO BELLINI,PV,3344,1687,1657,1030571690,018173,L720
7540,VELO D'ASTICO,VI,2244,1114,1130,1050901150,024115,L723
7541,VELO VERONESE,VR,771,408,363,1050890890,023090,L722
7542,VELTURNO/FELDTHURNS,BZ,3049,1549,1500,1040141031,021116,L724
7543,VENAFRO,IS,11006,5391,5615,3140940520,094052,L725
7544,VENARIA REALE,TO,32462,15704,16758,1010812790,001292,L727
7545,VENAROTTA,AP,1914,956,958,2110060720,044073,L728
7546,VENASCA,CN,1348,657,691,1010272360,004237,L729
7547,VENAUS,TO,871,439,432,1010812791,001291,L726
7548,VENDONE,SV,366,179,187,1070740660,009066,L730
7549,VENEGONO INFERIORE,VA,5952,2905,3047,1030861181,012136,L733
7550,VENEGONO SUPERIORE,VA,7257,3584,3673,1030861190,012137,L734
7551,VENETICO,ME,3918,1870,2048,4190481020,083104,L735
7552,VENEZIA,VE,251944,120714,131230,1050870420,027042,L736
7553,VENIANO,CO,3078,1510,1568,1030242240,013238,L737
7554,VENOSA,PZ,11035,5472,5563,3170640940,076095,L738
7555,VENTASSO,RE,3964,1968,1996,1080680415,035046,M364
7556,VENTICANO,AV,2289,1121,1168,3150081140,064116,L739
7557,VENTIMIGLIA,IM,23018,11292,11726,1070370610,008065,L741
7558,VENTIMIGLIA DI SICILIA,PA,1851,909,942,4190550740,082077,L740
7559,VENTOTENE,LT,704,389,315,2120400330,059033,L742
7560,VENZONE,UD,1953,979,974,1060851310,030131,L743
7561,VERANO BRIANZA,MB,9171,4506,4665,1031040480,108048,L744
7562,VERANO/VORAN,BZ,985,517,468,1040141040,021112,L745
7563,VERBANIA,VB,29856,14153,15703,1011020720,103072,L746
7564,VERBICARO,CS,2674,1326,1348,3180251530,078153,L747
7565,VERCANA,CO,743,371,372,1030242250,013239,L748
7566,VERCEIA,SO,1063,522,541,1030770750,014075,L749
7567,VERCELLI,VC,45176,21661,23515,1010881560,002158,L750
7568,VERCURAGO,LC,2734,1303,1431,1030980860,097086,L751
7569,VERDELLINO,BG,7509,3912,3597,1030122210,016232,L752
7570,VERDELLO,BG,8118,4144,3974,1030122220,016233,L753
7571,VERDERIO,LC,5508,2761,2747,1030980873,097091,M337
7572,VERDUNO,CN,562,268,294,1010272370,004238,L758
7573,VERGATO,BO,7521,3746,3775,1080130590,037059,L762
7574,VERGHERETO,FC,1763,891,872,1080320490,040050,L764
7575,VERGIATE,VA,8652,4252,4400,1030861200,012138,L765
7576,VERMEZZO CON ZELO,MI,5831,2876,2955,1030492335,015251,M424
7577,VERMIGLIO,TN,1795,885,910,1040832020,022213,L769
7578,VERNANTE,CN,1104,531,573,1010272380,004239,L771
7579,VERNASCA,PC,2000,1011,989,1080610440,033044,L772
7580,VERNATE,MI,3332,1687,1645,1030492340,015236,L773
7581,VERNAZZA,SP,759,373,386,1070390300,011030,L774
7582,VERNIO,PO,6066,3013,3053,2091000070,100007,L775
7583,VERNOLE,LE,6774,3243,3531,3160410920,075093,L776
7584,VEROLANUOVA,BS,8018,3985,4033,1030151860,017195,L777
7585,VEROLAVECCHIA,BS,3754,1922,1832,1030151870,017196,L778
7586,VEROLENGO,TO,4782,2331,2451,1010812800,001293,L779
7587,VEROLI,FR,19849,9799,10050,2120330840,060085,L780
7588,VERONA,VR,255985,122107,133878,1050890900,023091,L781
7589,VERONELLA,VR,5140,2614,2526,1050890910,023092,D193
7590,VERRAYES,AO,1294,656,638,1020040710,007072,L783
7591,VERRETTO,PV,377,194,183,1030571700,018174,L784
7592,VERRONE,BI,1177,587,590,1010960760,096076,L785
7593,VERRUA PO,PV,1187,576,611,1030571710,018175,L788
7594,VERRUA SAVOIA,TO,1341,678,663,1010812810,001294,L787
7595,VERRES,AO,2578,1276,1302,1020040720,007073,C282
7596,VERTEMATE CON MINOPRIO,CO,4118,2033,2085,1030242280,013242,L792
7597,VERTOVA,BG,4443,2174,2269,1030122230,016234,L795
7598,VERUCCHIO,RN,10045,5048,4997,1081010200,099020,L797
7599,VERVIO,SO,202,103,99,1030770760,014076,L799
7600,VERZEGNIS,UD,838,427,411,1060851320,030132,L801
7601,VERZINO,KR,1616,766,850,3180970270,101027,L802
7602,VERZUOLO,CN,6417,3196,3221,1010272390,004240,L804
7603,VESCOVANA,PD,1720,847,873,1050540970,028097,L805
7604,VESCOVATO,CR,3817,1907,1910,1030261100,019113,L806
7605,VESIME,AT,592,310,282,1010071130,005113,L807
7606,VESPOLATE,NO,2015,1002,1013,1010521510,003158,L808
7607,VESSALICO,IM,247,132,115,1070370620,008066,L809
7608,VESTENANOVA,VR,2498,1297,1201,1050890920,023093,L810
7609,VESTIGNE',TO,753,375,378,1010812820,001295,L811
7610,VESTONE,BS,4181,2084,2097,1030151880,017197,L812
7611,VETRALLA,VT,13384,6547,6837,2120910560,056057,L814
7612,VETTO,RE,1784,926,858,1080680420,035042,L815
7613,VEZZA D'ALBA,CN,2352,1192,1160,1010272400,004241,L817
7614,VEZZA D'OGLIO,BS,1473,734,739,1030151890,017198,L816
7615,VEZZANO LIGURE,SP,7212,3517,3695,1070390310,011031,L819
7616,VEZZANO SUL CROSTOLO,RE,4298,2099,2199,1080680430,035043,L820
7617,VEZZI PORTIO,SV,795,396,399,1070740670,009067,L823
7618,VIADANA,MN,19781,9930,9851,1030450660,020066,L826
7619,VIADANICA,BG,1123,561,562,1030122240,016235,L827
7620,VIAGRANDE,CT,8789,4310,4479,4190210510,087053,L828
7621,VIALE,AT,250,126,124,1010071140,005114,L829
7622,VIALFRE',TO,257,129,128,1010812830,001296,L830
7623,VIANO,RE,3338,1662,1676,1080680440,035044,L831
7624,VIAREGGIO,LU,61045,29190,31855,2090430330,046033,L833
7625,VIARIGI,AT,868,434,434,1010071150,005115,L834
7626,VIBO VALENTIA,VV,31480,15254,16226,3181030470,102047,F537
7627,VIBONATI,SA,3215,1598,1617,3150721560,065156,L835
7628,VICALVI,FR,743,351,392,2120330850,060086,L836
7629,VICARI,PA,2461,1181,1280,4190550750,082078,L837
7630,VICCHIO,FI,8022,4009,4013,2090300490,048049,L838
7631,VICENZA,VI,110293,52852,57441,1050901160,024116,L840
7632,VICO DEL GARGANO,FG,7353,3613,3740,3160310570,071059,L842
7633,VICO EQUENSE,,20363,9940,10423,3150510860,063086,L845
7634,VICO NEL LAZIO,FR,2072,1015,1057,2120330860,060087,L843
7635,VICOFORTE,CN,3168,1557,1611,1010272410,004242,L841
7636,VICOLI,PE,381,188,193,3130600450,068045,L846
7637,VICOLUNGO,NO,826,399,427,1010521520,003159,L847
7638,VICOPISANO,PI,8553,4134,4419,2090620370,050038,L850
7639,VICOVARO,RM,3624,1786,1838,2120701110,058112,L851
7640,VIDDALBA,SS,1623,809,814,4200730742,090082,M259
7641,VIDIGULFO,PV,6555,3263,3292,1030571720,018176,L854
7642,VIDOR,TV,3690,1829,1861,1050840890,026090,L856
7643,VIDRACCO,TO,482,228,254,1010812850,001298,L857
7644,VIESTE,FG,13434,6673,6761,3160310580,071060,L858
7645,VIETRI DI POTENZA,PZ,2683,1329,1354,3170640950,076096,L859
7646,VIETRI SUL MARE,SA,7318,3624,3694,3150721570,065157,L860
7647,VIGANO SAN MARTINO,BG,1322,673,649,1030122250,016236,L865
7648,VIGANO',LC,2093,1044,1049,1030980900,097090,L866
7649,VIGARANO MAINARDA,FE,7571,3726,3845,1080290200,038022,L868
7650,VIGASIO,VR,10220,5143,5077,1050890930,023094,L869
7651,VIGEVANO,PV,62201,30184,32017,1030571730,018177,L872
7652,VIGGIANELLO,PZ,2758,1379,1379,3170640960,076097,L873
7653,VIGGIANO,PZ,3284,1675,1609,3170640970,076098,L874
7654,VIGGIU',VA,5167,2451,2716,1030861210,012139,L876
7655,VIGLIANO BIELLESE,BI,7596,3636,3960,1010960770,096077,L880
7656,VIGLIANO D'ASTI,AT,816,410,406,1010071160,005116,L879
7657,VIGNALE MONFERRATO,AL,943,445,498,1010021760,006179,L881
7658,VIGNANELLO,VT,4299,2125,2174,2120910570,056058,L882
7659,VIGNATE,MI,9253,4571,4682,1030492350,015237,L883
7660,VIGNOLA,MO,25686,12517,13169,1080500450,036046,L885
7661,VIGNOLA-FALESINA,TN,181,99,82,1040832041,022216,L886
7662,VIGNOLE BORBERA,AL,2022,982,1040,1010021770,006180,L887
7663,VIGNOLO,CN,2643,1310,1333,1010272420,004243,L888
7664,VIGNONE,VB,1195,591,604,1011020740,103074,L889
7665,VIGO DI CADORE,BL,1358,663,695,1050100650,025065,L890
7666,VIGODARZERE,PD,13104,6443,6661,1050540990,028099,L892
7667,VIGOLO,BG,577,291,286,1030122260,016237,L894
7668,VIGOLZONE,PC,4218,2097,2121,1080610450,033045,L897
7669,VIGONE,TO,5086,2531,2555,1010812860,001299,L898
7670,VIGONOVO,VE,9890,4875,5015,1050870430,027043,L899
7671,VIGONZA,PD,23082,11288,11794,1050541000,028100,L900
7672,VIGUZZOLO,AL,3054,1529,1525,1010021780,006181,L904
7673,VILLA BARTOLOMEA,VR,5782,2877,2905,1050890940,023095,L912
7674,VILLA BASILICA,LU,1491,735,756,2090430340,046034,L913
7675,VILLA BISCOSSI,PV,61,25,36,1030571740,018178,L917
7676,VILLA CARCINA,BS,10694,5283,5411,1030151900,017199,L919
7677,VILLA CASTELLI,BR,9079,4504,4575,3160160200,074020,L920
7678,VILLA CELIERA,PE,556,269,287,3130600460,068046,L922
7679,VILLA COLLEMANDINA,LU,1215,611,604,2090430350,046035,L926
7680,VILLA CORTESE,MI,6175,3038,3137,1030492351,015248,L928
7681,VILLA D'ADDA,BG,4575,2254,2321,1030122270,016238,L929
7682,VILLA D'ALME',BG,6573,3250,3323,1030122271,016239,A215
7683,VILLA D'OGNA,BG,1782,870,912,1030122290,016241,L938
7684,VILLA DEL BOSCO,BI,316,147,169,1010960780,096078,L933
7685,VILLA DEL CONTE,PD,5562,2832,2730,1050541010,028101,L934
7686,VILLA DI BRIANO,CE,7308,3670,3638,3150200980,061098,D801
7687,VILLA DI CHIAVENNA,SO,967,503,464,1030770770,014077,L907
7688,VILLA DI SERIO,BG,6630,3307,3323,1030122280,016240,L936
7689,VILLA DI TIRANO,SO,2996,1484,1512,1030770780,014078,L908
7690,VILLA ESTENSE,PD,2105,1054,1051,1050541020,028102,L937
7691,VILLA FARALDI,IM,448,223,225,1070370630,008067,L943
7692,VILLA GUARDIA,CO,7877,3840,4037,1030242300,013245,L956
7693,VILLA LAGARINA,TN,3881,1952,1929,1040832100,022222,L957
7694,VILLA LATINA,FR,1156,582,574,2120330870,060088,A081
7695,VILLA LITERNO,CE,12331,6372,5959,3150200990,061099,L844
7696,VILLA MINOZZO,RE,3517,1794,1723,1080680450,035045,L969
7697,VILLA SAN GIOVANNI,RC,12920,6309,6611,3180670960,080096,M018
7698,VILLA SAN GIOVANNI IN TUSCIA,VT,1202,613,589,2120910571,056046,H913
7699,VILLA SAN PIETRO,CA,2165,1095,1070,4200170990,092099,I118
7700,VILLA SAN SECONDO,AT,379,184,195,1010071190,005119,M019
7701,VILLA SANT'ANGELO,AQ,485,234,251,3130381031,066105,M023
7702,VILLA SANT'ANTONIO,OR,333,166,167,4200950711,095048,I298
7703,VILLA SANTA LUCIA,FR,2529,1272,1257,2120330880,060089,L905
7704,VILLA SANTA LUCIA DEGLI ABRUZZI,AQ,91,48,43,3130381030,066104,M021
7705,VILLA SANTA MARIA,CH,1120,563,557,3130231020,069102,M022
7706,VILLA SANTINA,UD,2170,1013,1157,1060851330,030133,L909
7707,VILLA SANTO STEFANO,FR,1651,814,837,2120330890,060090,I364
7708,VILLA VERDE,OR,288,139,149,4200950730,095073,A609
7709,VILLABASSA/NIEDERDORF,BZ,1581,806,775,1040141050,021113,L915
7710,VILLABATE,PA,19731,9688,10043,4190550760,082079,L916
7711,VILLACHIARA,BS,1360,689,671,1030151910,017200,L923
7712,VILLACIDRO,SU,13317,6624,6693,4201110960,111096,L924
7713,VILLADEATI,AL,481,239,242,1010021790,006182,L931
7714,VILLADOSE,RO,4796,2346,2450,1050710480,029048,L939
7715,VILLADOSSOLA,VB,6233,3015,3218,1011020750,103075,L906
7716,VILLAFALLETTO,CN,2859,1424,1435,1010272430,004244,L942
7717,VILLAFRANCA D'ASTI,AT,2930,1441,1489,1010071170,005117,L945
7718,VILLAFRANCA DI VERONA,VR,33044,16255,16789,1050890950,023096,L949
7719,VILLAFRANCA IN LUNIGIANA,MS,4611,2299,2312,2090460160,045016,L946
7720,VILLAFRANCA PADOVANA,PD,10515,5150,5365,1050541030,028103,L947
7721,VILLAFRANCA PIEMONTE,TO,4562,2252,2310,1010812870,001300,L948
7722,VILLAFRANCA SICULA,AG,1345,649,696,4190010420,084043,L944
7723,VILLAFRANCA TIRRENA,ME,8148,3834,4314,4190481030,083105,L950
7724,VILLAFRATI,PA,3083,1511,1572,4190550770,082080,L951
7725,VILLAGA,VI,1872,940,932,1050901170,024117,L952
7726,VILLAGRANDE STRISAILI,NU,3011,1519,1492,4200530980,091101,L953
7727,VILLALAGO,AQ,520,256,264,3130381020,066103,L958
7728,VILLALBA,CL,1446,701,745,4190180220,085022,L959
7729,VILLALFONSINA,CH,897,451,446,3130231000,069100,L961
7730,VILLALVERNIA,AL,876,430,446,1010021800,006183,L963
7731,VILLAMAGNA,CH,2172,1084,1088,3130231010,069101,L964
7732,VILLAMAINA,AV,916,435,481,3150081150,064117,L965
7733,VILLAMAR,SU,2472,1258,1214,4201110970,111097,L966
7734,VILLAMARZANA,RO,1148,584,564,1050710490,029049,L967
7735,VILLAMASSARGIA,SU,3440,1716,1724,4201110980,111098,L968
7736,VILLAMIROGLIO,AL,299,152,147,1010021810,006184,L970
7737,VILLANDRO/VILLANDERS,BZ,1892,979,913,1040141060,021114,L971
7738,VILLANOVA BIELLESE,BI,182,91,91,1010960790,096079,L978
7739,VILLANOVA CANAVESE,TO,1205,582,623,1010812880,001301,L982
7740,VILLANOVA D'ALBENGA,SV,2764,1376,1388,1070740680,009068,L975
7741,VILLANOVA D'ARDENGHI,PV,770,387,383,1030571750,018179,L983
7742,VILLANOVA D'ASTI,AT,5497,2695,2802,1010071180,005118,L984
7743,VILLANOVA DEL BATTISTA,AV,1478,715,763,3150081160,064118,L973
7744,VILLANOVA DEL GHEBBO,RO,1983,999,984,1050710500,029050,L985
7745,VILLANOVA DEL SILLARO,LO,1850,974,876,1030990600,098060,L977
7746,VILLANOVA DI CAMPOSAMPIERO,PD,6111,3061,3050,1050541040,028104,L979
7747,VILLANOVA MARCHESANA,RO,879,448,431,1050710510,029051,L988
7748,VILLANOVA MONDOVI',CN,5819,2865,2954,1010272440,004245,L974
7749,VILLANOVA MONFERRATO,AL,1748,840,908,1010021820,006185,L972
7750,VILLANOVA MONTELEONE,SS,2124,1055,1069,4200730750,090078,L989
7751,VILLANOVA SOLARO,CN,735,379,356,1010272450,004246,L990
7752,VILLANOVA SULL'ARDA,PC,1684,850,834,1080610460,033046,L980
7753,VILLANOVA TRUSCHEDU,OR,293,135,158,4200950710,095071,L991
7754,VILLANOVA TULO,SU,1019,535,484,4201110990,111099,L992
7755,VILLANOVAFORRU,SU,622,326,296,4201111000,111100,L986
7756,VILLANOVAFRANCA,SU,1201,614,587,4201111010,111101,L987
7757,VILLANTERIO,PV,3324,1684,1640,1030571760,018180,L994
7758,VILLANUOVA SUL CLISI,BS,5834,2853,2981,1030151920,017201,L995
7759,VILLAPERUCCIO,SU,1010,495,515,4201111020,111102,M278
7760,VILLAPIANA,CS,5439,2687,2752,3180251540,078154,B903
7761,VILLAPUTZU,SU,4509,2221,2288,4201111030,111103,L998
7762,VILLAR DORA,TO,2795,1396,1399,1010812891,001303,L999
7763,VILLAR FOCCHIARDO,TO,1955,955,1000,1010812910,001305,M007
7764,VILLAR PELLICE,TO,1047,523,524,1010812920,001306,M013
7765,VILLAR PEROSA,TO,3898,1894,2004,1010812930,001307,M014
7766,VILLAR SAN COSTANZO,CN,1541,793,748,1010272460,004247,M015
7767,VILLARBASSE,TO,3500,1682,1818,1010812890,001302,M002
7768,VILLARBOIT,VC,386,191,195,1010881610,002163,M003
7769,VILLAREGGIA,TO,996,489,507,1010812900,001304,M004
7770,VILLARICCA,,31284,15208,16076,3150510870,063087,G309
7771,VILLAROMAGNANO,AL,653,323,330,1010021830,006186,M009
7772,VILLAROSA,EN,4450,2109,2341,4190280200,086020,M011
7773,VILLASALTO,SU,989,501,488,4201111040,111104,M016
7774,VILLASANTA,MB,14068,6779,7289,1031040490,108049,M017
7775,VILLASIMIUS,SU,3705,1871,1834,4201111050,111105,B738
7776,VILLASOR,SU,6599,3291,3308,4201111060,111106,M025
7777,VILLASPECIOSA,SU,2536,1261,1275,4201111070,111107,M026
7778,VILLASTELLONE,TO,4472,2175,2297,1010812940,001308,M027
7779,VILLATA,VC,1550,774,776,1010881620,002164,M028
7780,VILLAURBANA,OR,1490,745,745,4200950720,095072,M030
7781,VILLAVALLELONGA,AQ,836,400,436,3130381040,066106,M031
7782,VILLAVERLA,VI,6047,3064,2983,1050901180,024118,M032
7783,VILLE D'ANAUNIA,TN,4729,2354,2375,1040832111,022249,M363
7784,VILLE DI FIEMME,TN,2637,1323,1314,1040832115,022254,M431
7785,VILLENEUVE,AO,1278,684,594,1020040730,007074,L981
7786,VILLESSE,GO,1640,810,830,1060350210,031025,M043
7787,VILLETTA BARREA,AQ,589,305,284,3130381050,066107,M041
7788,VILLETTE,VB,273,134,139,1011020760,103076,M042
7789,VILLIMPENTA,MN,2093,1031,1062,1030450680,020068,M044
7790,VILLONGO,BG,8027,4129,3898,1030122300,016242,M045
7791,VILLORBA,TV,17603,8543,9060,1050840900,026091,M048
7792,VILMINORE DI SCALVE,BG,1441,710,731,1030122310,016243,M050
7793,VIMERCATE,MB,25783,12471,13312,1031040500,108050,M052
7794,VIMODRONE,MI,16753,8158,8595,1030492400,015242,M053
7795,VINADIO,CN,599,308,291,1010272470,004248,M055
7796,VINCHIATURO,CB,3296,1642,1654,3140190840,070084,M057
7797,VINCHIO,AT,548,282,266,1010071200,005120,M058
7798,VINCI,FI,14574,7134,7440,2090300500,048050,M059
7799,VINOVO,TO,15154,7411,7743,1010812950,001309,M060
7800,VINZAGLIO,NO,523,288,235,1010521550,003164,M062
7801,VIOLA,CN,359,186,173,1010272480,004249,M063
7802,VIONE,BS,627,302,325,1030151930,017202,M065
7803,VIPITENO/STERZING,BZ,6968,3475,3493,1040141070,021115,M067
7804,VIRLE PIEMONTE,TO,1153,585,568,1010812960,001310,M069
7805,VISANO,BS,1992,1009,983,1030151940,017203,M070
7806,VISCHE,TO,1196,589,607,1010812970,001311,M071
7807,VISCIANO,,4199,2068,2131,3150510880,063088,M072
7808,VISCO,UD,816,388,428,1060851350,030135,M073
7809,VISONE,AL,1138,590,548,1010021840,006187,M077
7810,VISSO,MC,996,478,518,2110440570,043057,M078
7811,VISTARINO,PV,1518,771,747,1030571770,018181,M079
7812,VISTRORIO,TO,506,243,263,1010812980,001312,M080
7813,VITA,TP,1822,896,926,4190820220,081023,M081
7814,VITERBO,VT,65931,32103,33828,2120910580,056059,M082
7815,VITICUSO,FR,304,147,157,2120330900,060091,M083
7816,VITO D'ASIO,PN,720,356,364,1060930490,093049,M085
7817,VITORCHIANO,VT,5249,2601,2648,2120910590,056060,M086
7818,VITTORIA,RG,62533,31472,31061,4190650120,088012,M088
7819,VITTORIO VENETO,TV,27310,13101,14209,1050840910,026092,M089
7820,VITTORITO,AQ,822,385,437,3130381060,066108,M090
7821,VITTUONE,MI,9274,4563,4711,1030492410,015243,M091
7822,VITULANO,BN,2734,1417,1317,3150110750,062077,M093
7823,VITULAZIO,CE,7560,3653,3907,3150201000,061100,M092
7824,VIU',TO,1023,529,494,1010812990,001313,M094
7825,VIVARO,PN,1292,680,612,1060930500,093050,M096
7826,VIVARO ROMANO,RM,165,91,74,2120701120,058113,M095
7827,VIVERONE,BI,1353,651,702,1010960800,096080,M098
7828,VIZZINI,CT,5747,2758,2989,4190210520,087054,M100
7829,VIZZOLA TICINO,VA,586,307,279,1030861220,012140,M101
7830,VIZZOLO PREDABISSI,MI,3852,1881,1971,1030492420,015244,M102
7831,VO',PD,3283,1620,1663,1050541050,028105,M103
7832,VOBARNO,BS,8257,4182,4075,1030151950,017204,M104
7833,VOBBIA,GE,365,193,172,1070340660,010066,M105
7834,VOCCA,VC,157,84,73,1010881640,002166,M106
7835,VODO CADORE,BL,822,392,430,1050100660,025066,M108
7836,VOGHERA,PV,38316,18458,19858,1030571780,018182,M109
7837,VOGHIERA,FE,3633,1769,1864,1080290210,038023,M110
7838,VOGOGNA,VB,1707,864,843,1011020770,103077,M111
7839,VOLANO,TN,3063,1551,1512,1040832120,022224,M113
7840,VOLLA,,25369,12497,12872,3150510890,063089,M115
7841,VOLONGO,CR,463,242,221,1030261110,019114,M116
7842,VOLPAGO DEL MONTELLO,TV,10062,4973,5089,1050840920,026093,M118
7843,VOLPARA,PV,124,69,55,1030571790,018183,M119
7844,VOLPEDO,AL,1157,567,590,1010021850,006188,M120
7845,VOLPEGLINO,AL,134,69,65,1010021860,006189,M121
7846,VOLPIANO,TO,15199,7472,7727,1010813000,001314,M122
7847,VOLTA MANTOVANA,MN,7205,3543,3662,1030450700,020070,M125
7848,VOLTAGGIO,AL,667,327,340,1010021870,006190,M123
7849,VOLTAGO AGORDINO,BL,829,392,437,1050100670,025067,M124
7850,VOLTERRA,PI,9696,4631,5065,2090620380,050039,M126
7851,VOLTIDO,CR,328,168,160,1030261120,019115,M127
7852,VOLTURARA APPULA,FG,391,183,208,3160310590,071061,M131
7853,VOLTURARA IRPINA,AV,3021,1464,1557,3150081170,064119,M130
7854,VOLTURINO,FG,1554,741,813,3160310600,071062,M132
7855,VOLVERA,TO,8521,4224,4297,1010813010,001315,M133
7856,VOTTIGNASCO,CN,497,252,245,1010272490,004250,M136
7857,ZACCANOPOLI,VV,673,332,341,3181030480,102048,M138
7858,ZAFFERANA ETNEA,CT,9383,4715,4668,4190210530,087055,M139
7859,ZAGARISE,CZ,1475,723,752,3180221530,079157,M140
7860,ZAGAROLO,RM,18344,9272,9072,2120701130,058114,M141
7861,ZAMBRONE,VV,1784,876,908,3181030490,102049,M143
7862,ZANDOBBIO,BG,2666,1360,1306,1030122320,016244,M144
7863,ZANE',VI,6587,3233,3354,1050901190,024119,M145
7864,ZANICA,BG,8671,4340,4331,1030122330,016245,M147
7865,ZAPPONETA,FG,3284,1695,1589,3160310601,071064,M267
7866,ZAVATTARELLO,PV,925,456,469,1030571800,018184,M150
7867,ZECCONE,PV,1696,834,862,1030571810,018185,M152
7868,ZEDDIANI,OR,1131,570,561,4200950740,095074,M153
7869,ZELBIO,CO,182,100,82,1030242310,013246,M156
7870,ZELO BUON PERSICO,LO,7418,3621,3797,1030990610,098061,M158
7871,ZEME,PV,996,517,479,1030571820,018186,M161
7872,ZENEVREDO,PV,476,239,237,1030571830,018187,M162
7873,ZENSON DI PIAVE,TV,1741,856,885,1050840930,026094,M163
7874,ZERBA,PC,70,40,30,1080610470,033047,M165
7875,ZERBO,PV,396,190,206,1030571840,018188,M166
7876,ZERBOLO',PV,1645,830,815,1030571850,018189,M167
7877,ZERFALIU,OR,1017,493,524,4200950750,095075,M168
7878,ZERI,MS,970,464,506,2090460170,045017,M169
7879,ZERMEGHEDO,VI,1347,702,645,1050901200,024120,M170
7880,ZERO BRANCO,TV,11488,5724,5764,1050840940,026095,M171
7881,ZEVIO,VR,15492,7734,7758,1050890960,023097,M172
7882,ZIANO DI FIEMME,TN,1758,856,902,1040832140,022226,M173
7883,ZIANO PIACENTINO,PC,2441,1262,1179,1080610480,033048,L848
7884,ZIBIDO SAN GIACOMO,MI,6837,3427,3410,1030492450,015247,M176
7885,ZIGNAGO,SP,475,242,233,1070390320,011032,M177
7886,ZIMELLA,VR,4824,2465,2359,1050890970,023098,M178
7887,ZIMONE,BI,392,199,193,1010960810,096081,M179
7888,ZINASCO,PV,3075,1500,1575,1030571860,018190,M180
7889,ZOAGLI,GE,2306,1134,1172,1070340670,010067,M182
7890,ZOCCA,MO,4572,2309,2263,1080500460,036047,M183
7891,ZOGNO,BG,8585,4209,4376,1030122340,016246,M184
7892,ZOLA PREDOSA,BO,19117,9324,9793,1080130600,037060,M185
7893,ZOLLINO,LE,1892,900,992,3160410930,075094,M187
7894,ZONE,BS,1039,524,515,1030151960,017205,M188
7895,ZOPPE' DI CADORE,BL,191,94,97,1050100690,025069,M189
7896,ZOPPOLA,PN,8346,4165,4181,1060930510,093051,M190
7897,ZOVENCEDO,VI,798,426,372,1050901210,024121,M194
7898,ZUBIENA,BI,1117,558,559,1010960820,096082,M196
7899,ZUCCARELLO,SV,286,141,145,1070740690,009069,M197
7900,ZUGLIANO,VI,6783,3279,3504,1050901220,024122,M199
7901,ZUGLIO,UD,552,272,280,1060851360,030136,M200
7902,ZUMAGLIA,BI,983,473,510,1010960830,096083,M201
7903,ZUMPANO,CS,2633,1315,1318,3180251550,078155,M202
7904,ZUNGOLI,AV,976,471,505,3150081180,064120,M203
7905,ZUNGRI,VV,1882,949,933,3181030500,102050,M204
